766666666666677777-
766777777766676667-
766766666766676667-
766766666766676667-
766766666766676667-
766766666766676667-
766766666766676667-
777766666777776667