444444444444444444444444444444444444444444444444444444444444444444444444444444444444444444444444444444444444444444444444444444444444444444444444444444-
412111020222222011102101002000010010112022210201000012202001000021222011200202202202100110122212120020122011000000221220021210222022210021101011022214-
421202000210010020000110220221001200112121222012222001122210020022222100001012102102011220212222210222102211110111122021101111101211110121220002120204-
411000220101002110021100121101200120220021001110002012221202100021202222120020021110122222210101022112121012211112001200221020101101102012020121022214-
420001021022111112211000000111222121002120211111101001020212100201122122201021211012221020022100011201002212011222100021101121111022222001121221221204-
420011212121212021221112202200012020010010120021002200020222210101220110102012000111202221202021120100102102210011202122201201021122110221010010000204-
420102122211221022122102202111200212222121121111220010110202010200112212021211222102200010002122221220001020001221111212200221001011122001210201021114-
412102010220112202120002102102112101220012021210002112211001121011022201210122200210021010210221001001110012100112101212112220202022211111221201011214-
411200011011120210102200001210220222212010102102201202021211221112100000000211221202202010211120220111122211020211001210001121120011112211212111122214-
402200012121110102111011212112012001211201221220010110120202002221220121112000212110112111222220002012221001212221112000212010201020112202001120212004-
421022201010002100002222202200010220201012100200220002220002110202201221011201220011012102102100100010101211100200200000222100012112110100222202101124-
421201112110010212000020110211200100222002211202002002100101010100101120000102200102202102021120210101002210121102021111202212012210222011202112001104-
401101012120102022110220101212221202002020112020112120121102012222201111122010112012002011002101121210020022121212221101021120221220012101110112001004-
420020022012221120222212100021111020012102220210012202211122011211210022112121212220220001122121211100010221020012021001222112221112211210102012120014-
411220002021122100222200210221202100100000112102022021212102211202212122201021200002101212020100200012010220220011020102012021201220110200211002101014-
411201122222000001002201202201222001211210021122202222101111201021220102001222110011021001020212220002110112001020022021000111002000121011221201221104-
400112100000120021222012101120222011100000102000001021212000021212110222210222120120100221200222100211010012102001122202102112121200202122022000102104-
400201111202110012120111212020020201102122212121110020212222012101201010210102122122110210201200111112112101010010122002010112012102011010011211122204-
422002202100102221122000212200112211112012222201220200002221201111220101101200001112212211022010021122200211022220210212100022000221212110112100101024-
410100100101101110011220010122111201110210020221101022121202022102110011200210110110001101011010201220010111110111120122100102212002202112220200200024-
420111211122010100201022010011202020212101001202210120200212012021101201001012222211120112211121010200020202020101111112011012110001121101120010202204-
401001120022111212002200010022102001221222211202010200202220100200100012101000110001100110212211102020122000111010121202210201201201121102100021112204-
420022121012112101121202110010021222202222100100112110211111021122220000022000212110111012100220001001112202111011201122112101010111212111210002010114-
411000221010222201201210011012222100211122100012122010010100212100222210110210101000102001120010122000221211221102202002122001220201100120002100221004-
400222110120002120211012210222200212021001002021110122210111020211221102012210221102210211020010102022022111001002121220112122210100221100201101202024-
401022201200211010111220011100102022220001001220122022021221021212121021220121101121122101220011100102002002001010211122110020101011120102102001211124-
421011212101001210220102102011211100220111110201010201202021120012000022001212111010110221210022212121012222202001222121021102020212022021020120221024-
421121111211010220020201120101000021211012011010211200011222122022112222110020122100202120121202012010210020001000002111111000201010222111111001110124-
412201012220101021011011221212020121001102011111121100211112110000201010112201201221010000101020122200000222211002112022222202212212202200121221122104-
412102100201110022211012200011011200010021222201221011120221020202010200100212210202100202121220101110000001222202022221021011012201112222220120220224-
412221011120200220201122222211221201000120121100212212221212102001122020221202021012022210210200121121000002020000100020221200212012011200111112101204-
402221111001011112001120021102122122210121101221202100002000000111121100210121201011100202202210020012101222211111201102000201221201210001110202011024-
401200221001211221121021211221211121222010101012012121020121020212012000020022000102222112222111210022212211120202201210110201221212101210101001100004-
402201110210201111112100102122100202102211110212022210200200020100101101002102112211001210000100112201011121102210201010121202100022222120001222212024-
401011210201202102020122000112220000110020111022021110111011110100000121021022212111221000000012100222210100121201022001110111102011021212002021210224-
422211000122112210201111210120111201202111201101000121112112122101121001222211200121101010101100002122222012210200200001121022211201212201002002122004-
411202002210102002100100012121101010002012000022210200120002222121110202212022000020221010211001022021002122110112000110222002100011010211211211112114-
420022111120122101002010000122110222220200220010020102221122202112122211022212000010222220020122102020001201101021102102002210102100012011102202010104-
410222220011022021111112202221220012201000210011110210101201122000002100102202002201010120102120020012210202020120111001000011202120201111112100011004-
412020000022112212200010210121200021100122100102000201221200110211221222121210212201120111021211001110212111100102100020000202210211220201100221022004-
422110210210002111202201111221000222000220202121210021112112020102100022211211100111120101222120220202201110000120210201201102002002221010101111201114-
400002021201222000222202220201121220120222111110120201202221111212212121102020200211011121112021220010111112020002000011101210100122211220002010112214-
412001011120021122112011220102102122110021211200101002011212121200002100012002202210101202011111112101201000022211221022221020202011000210110200020004-
421121111021211220120200022122122110221120220120021210112221200122220012000002010001200210021211001202201122101012220211221101000101011010101021210004-
401212120100001012111102120020010121111202011002100012001110101110101100100022202220010211222001212210001012102011100020221011102012211221221201122214-
410111120022100100001112211122222002201111100111222120102121201011020120122222102020020121221121002211122001210210100201202201201000212121022111210024-
411211111011210220110120110210112222122020200010022102122120212212222212121101112121220022021020200100012120021221001220111200200210110120020222012004-
400012102001121102112212121001111221001211101221000210202002201120111002001211201101221221100011101022001021211111201022102020112111201201011012002124-
400122110110212211200011212001000121100001221000121011000011221120111120211021102200221220102021011012010020020012021121121222022101220210201222210224-
444444444444444444444444444444444444444444444444444444444444444444444444444444444444444444444444444444444444444444444444444444444444444444444444444444-
