444444444444444444444444444444444444444444444444444444444444444444444444444444444444444444444444444444444444444444444444444444444444444444444444444444-
400211110212201021000110012200120110220220110112200211102100202020112112200211101200011020110222110000201221022221200100001000220111220112200120100224-
410122012001012000002112112211221010220012110022110200121202202212002212122120122022002120200121111112102222002202012022211202122101212222102001000214-
411012211000211002221201210212101210100202110112022000101021122020012210010102121102021100202211210221001200022110022011000211201120211000222120111204-
422200201010101112000201121120010022210202000012110000210101001220020221201012112011121101000012020000111202121001221111120100111200200122120212121204-
400221012100020002100011001100011020201121122121222212120212121011200202110012110200200100221101111020201202220112120212111022212010220202001021220104-
410221202011000221211112001022221011222200221212120102112202122111002110200110000010101200210201101002012110212222011111221112202010121120111000100204-
422012102201111012001221211211221101222112201011212212021021021100221210010111212022020011200112111120121100120112220102012120202201001000201211120004-
411022200001101101211222212112102122112221021220211102011102200021202210111222111200112200200210122101110010101011200122010221000121111210102021000224-
411210200210200002001211100101220022221222121210212202122000011000000022122212100010121202210221201122000000120201112000011110220220120021111010201224-
411110000212201011202201022001001220221210102201002222001022202011001020110100202212020200002112221111210102220122211122222011101101212220201110102204-
421022120120021120221010220102202101210200111110222000202202020112100120021012001222201000120122200121121011012200101022011001021000212011110020202224-
421122111112010211022211001101000112112202220020012102102012211021122000110111101221222121102002010020101220022212111020122121201200222011220200210214-
410021022211102011000112220110210210010120001100220112000111210222100122102112211001102221102002110200012220002021001002112020021221221102200222220114-
421210010211102222121001021111212020210010200100211221012111102211100211202120022221120110110200221101002112002100121012102110011111001122101121110014-
411210212102112101111112012121010121011000120010211102122220120122011202201001221111121112121100211220120201011022221200020220121212202220102112212204-
401012200220121120002112210100200012211012222022011111020212101210000102221212222001121221202101012221021011200112212100020120002001020201212201002104-
410202012201100100110011112022122200001221012101111110111112000021100020020100200112102110012202121200021100210100212201210021012121121220102001220224-
400211212202200012102001201112110021012201111111012112102001112122201121111021111202020101022212000111101101022102201121222012220001220120211011102024-
420010101112020110122212212102120120012000120001021120121020022222122002000012220210000201000121120002222022010102212210012101211100100212201220000214-
410101121011212002110112212121110202011210011000010210020121011121022021202000121221122120222002011010222112100200202000112212110002120002212100201024-
400110221210221202011011101221120220012211111202112001010000010022001020021122000020211202000120002022022121201202102101012101101122021112012120012224-
402002021202102220010202101001202101110121200000200211000112001211111112002212211200012000202010120001020012102021100222100011121001000002212000021214-
412112221022121021011010000100200021011101022110220000101211221211121001002022020202101202100000221110011122220020011012111200001121222102200012110004-
411110122012101101220102110020101122222220020002021001211020002100222120021002002102022010102220120202102210202222220210211122010012001110111122100014-
402022001012001022000220101220102202002122110222021100010022202011210011202121010200022021102202201121122212220111122000020121021021200212120101101124-
421111111121211022222202122010022011100221100100111220022001100000122100000011212200121002010020122001000121020112220112101110010102102002210101011004-
400012121122002012110021212020101102010211022002120202202011120200020100220201122022220101000200121022021101111000112022011021111110010201020112000024-
412222220011210222011201011001001101110010211000000221221212210110200120001220002221010111002021112001210112020101110110211101122000100122201201112024-
421100200011000000121222111111210111200022222002112121210002220020220221002120002021102012111012221022221121110212121002201200212121222102022011221024-
411221211020000001201112100020121000020221120011111210212221110012122221020202002001211220012101002212200010220102210212021011122210101221201010100104-
401002110210122200100020001020012122100220021221011220221000112110000011020122110221121022112011210212122102020011022022000000002121220101102100211014-
402010102101010212201211112210212101211210122202221122112020002212221022220222102120112011022101200220020210121201120000210111112010012000122100200104-
420002012201222121120021221010121121101221110021210101010121200221021201111201222222222121020220000022112102022100112220122222212102200111122011111214-
401200112120020112112101112110200102221122102102202002001020200110022000111200102102220020220200012210010212122211202211010002200112120121002221021204-
412211200000211020212122122111012202101012100100012021211221211102220000110210012020010101020002010012122022212002011120111001202011011112202120110124-
401201111002121220001211210012212021010220201021220212222012000002122102210221222001220202021010122002120100010222120101102221002110100211020102022214-
420122021002112001012120112020021110022110201120200102022112200011121212101211000020102101100120011111221122022010110211021100000012010101221202022124-
401121221020101110022122211200221121122022102202201022001100111212110022202101000200001001212111222020212111002002101112212221221122221011110200000004-
400200121112021000122211011001020221200111012001202220010212221022001101022001202000202112102100112112020011111021010002210221112221011201212000101124-
411112210001202210101202211211222221020200212002010000222011121101101010012202002010122021221221102012112201121022210110011121101210212100100011021204-
422212112122112222112010202020102101010020210021211221110020001010112202220210002122000110100121100100120222211111201110121100211101000022010000110224-
401021002021200101200122211121212202022111220021221121200201202101201012012001121220222221200001001010222112210220221011200020212011121101012222110024-
422222221001010212021210012220102020202001201210002102101021111111210212120020111120002110021121210010220002212122220201200201201211120100210210000024-
402001212021101110000002211110120221101110212202110011102202020222221002020002012112012110100002021220012100200200021000200000201212020222110001221204-
400020121211021002212100022020221100212112220002011121121200000002101100200120121012122121020120222221200211020021112010212202011012100101122221121214-
411012021010202101000010002112101210001121120112212220211211110001021122210022010220010001101220201200120110111122001100000111021002100211011101211114-
420022200122000202121122012200101011112100022222020112212110011122020000010000112010021000222110000210100121011222102222221010210002202211122122010124-
421010212002020210111210021120010200221001101221011001011102000110001112211011122211002001202111020122111200012002112012212201212002200010111122222224-
444444444444444444444444444444444444444444444444444444444444444444444444444444444444444444444444444444444444444444444444444444444444444444444444444444-
