444444444444444444444444444444444444444444444444444444444444444444444444444444444444444444444444444444444444444444444444444444444444444444444444444444-
402112211021212101202201011010010012201010021122122200002211100100200012022021102001201220000002022000211220221212000122022212102011110210012021021224-
410000110002202022121100111020202220022021120000001211020221100102220002101101012122210010210012021222011022110012010110001221000010212112221012200104-
400010021001100212002110002201000202022110021000102121011120202102201210100211202222220020011211202022101010012101102221020122112120100102210222222114-
402120011022011120201221101211021112021102111222211102222000010211100111022021110100012201012100000111212201212102201020110001110211001010111100011104-
410120200110221110120010022021022210122102101020200021000022121212120121022220200112222022202221210122212010100022201020200111211002000002211111112104-
410000100122012210000012021220022001102201001120101101200020121210012002220112202102002122022022221102122211211021221010112121001121010222101110112204-
401021100222110201102112221002000000212120012110102000021102212201121221120000010022110020210020022012202102100021202121110110001212122102210110000214-
411002202112012010001121022122101020202112120021122220122101020100010110010002001202102010202010020211212220222021011210201001200121120200122020211024-
410220112120102012122222112100221210021010100010010122012022121220220110101120022011121112011112010002200222120022110200210000222012201212022202021214-
402220101211212201200210200011212101220111112121020020211121110200112010112022212212022210022010120110021210220111122212121002021220212111000200222024-
402120112202202211101101102102100222122100100120221112122021021122121102001221220120110002022121100111112002112100200110222222020001012201011111120114-
400011121212111001001001220112211221121110002120201110111010221001001210010200022212000101002101021101212200020001000111120221021000202212212212112204-
412120011121011200102110221022200201011120102002101111211020221211020111201122020020221201120220002112120012012212211102202000120000021122210101121014-
411011011212122020110211210112000001100020120100100222122000212121201010221110000121011212000101012211100002122022022020022112000000111210111012102104-
402200102220000212102100101002102012220210210210220120000112201110102222022202121000101102200100202011212112221212101021122022201000101010102021201214-
412012122010102122111110121121001110000211202212000002212010212020202202112002110220112001000202221211221102210000012001201122020212111111101010102024-
400010102211002201202012100202000112121020021102211101221000221111221120202202001022221112211001122121220110202120022221000010202021211000011100120124-
412112220100200010112222002201101121020121100110201112200012121122220202002021022221011200002200212102121111112010012022221002110202021202201200010224-
410001122112022210022201102012110110101012102010122201112220112102012111020111002012111211120120010021122010200122001122122211010202212211202011021014-
410120120002001121101002200210120220202020111112211112001102001022002221021112012112111010210220022001200101111002000100001112200000211011122011112124-
412220010011120210021222120011101220111111201122021022212011001021010012001120220211102202012002110110001200221102210100001100002210200012012010212214-
402200200101020121222012120001201012021122112002111020120101110102122010221112102220200201100222220000210000001120010201010202122000201201100202200114-
400111020022100221111112010120110000202100210210211012220211112112202222101120122120121202120011102210220211002101011021200122212100021022012220222124-
401212101100222202020021120000211120111010112121120112201220211221000010200012102112020001021211012200002110010020121210121020010000220122021122000004-
411200012022211000221022222022100100222021122202000202121012112201022021221221220001121222211122110002012002120212020022212102012210011100112210101104-
421000121211101202020111112100011121121121021110000122211222212011000200202102211201000210020210210201100101212011210201110202110200200101020112010114-
422222211021212121011102201021122000122210001122121002222020001121022110100110212102110000122111100002110202011021020200210101211102212221001021102014-
420102202200002021022210010121011100011221220220112101020011201002222222011111121102110201221220110010101100222000122200002221220001212012202210012224-
421001210222222211202000000120011120112000222111020201202022011001211121010011222100022010202111120210211200102101112202201221211120112210021210201114-
422111200202101201220222111021012122021010220122022100122101001122220122112110021122011122211211211001222002010121212100022000202021012121202221210024-
401002011011110111222211221001022112110002022100201101202220022201012221222221012102012022022121010021001002120210120220210102112200011212112122101014-
400012212222222121110220222001222222012211211012201110220201120221002002121211210022120210022122000201012000011102000210222000100011120011002102112004-
422121202112212121011221221212002100122000020200020101010112122200222222120101000212101201220101011012200220211201100220112200201212102211111120200224-
401022212220221120122010010201210122010000021020210211112010002101212222100222021000211122201010020101212020101222220012122011012001012212110020210224-
422222200021011122210212200020022121020102010012200112120120012001021121122202220012021222000010122110001121201010222200222120002000001122000020022114-
400112102112002012100111000212111210122120212001122002100011200010002010112011120022212211010212100022221120012120001210121202022102121220201110002114-
402210102001122222001201000021200112120011011002210121002021012100002012001110221200020000012200011120100201122200102220002002002020102222012121122024-
422001211111000111021221112121211202121211020201221200111000211102202200002002201001010011111100011210201001020012211120020122102112210110010010220004-
421121221000110000001110121012002022212112121211221010212222102012002102200202211222012012001102102100221201201222020000100020222100120201202011021124-
410000000022112000012022121111211121210021000002211212201011020211111112222001120201220010110212000202021201212000022100112122211001010010112121202004-
421222211012200202212102200100022222212210110221002010200222202011020212222210112212122022020112102100011111120210010111010021201011221212022010011114-
402210102122020200021010120222111222100010010110211210022002010020222221011122102120021211221022021202101011021211001111120200210220102200011210000024-
400002010101021122222022020021210121222011002212121011200110122201210020022220122110110101200110111210102111220010200120110000020110200100111002211104-
422121110022010020201200121002112121120222002212222210120120122200002021211002102011121020100011010211102200022102210222021002121221112220012022111004-
420200222021210102000000101102201112122011112220221211121122010120022000101211000221221012022101100001112012120111120020021101102222122111020200100104-
421011021002001110022212011212122002020220110200010212021201101021212110212212022202001221110120111211020001020010002101220221202012201120200011201004-
400200121022112221221010121111202122210202001120100212002211221210100001011011110102200010021020222020102201010211111002001002002102120211211002001214-
411221000002202201120010102012111020111101122122100011201002122212221202012210202022002012010202012001011222010010021020012200222112201121101100002124-
444444444444444444444444444444444444444444444444444444444444444444444444444444444444444444444444444444444444444444444444444444444444444444444444444444-
