444444444444444444444444444444444444444444444444444444444444444444444444444444444444444444444444444444444444444444444444444444444444444444444444444444-
421120202201100020122220211211211101202110020221022121000111101221001210021010211220102110010001220112020102002210002122120112212011010110022200111114-
420020210202212100201101211211201201122101222122112000201200110020011201011211221000002210121212120112010021212002111200010220101122101021102212010124-
421221122111000010111011201022212122011002212002011021222220121200220201220211122120011001001110200211101100112100001102110102201212020221110122101124-
401122202022101122211111110110110212202020100122101112220122200001200222021201200212202211001011110112021100122202012000222220002122221111222122001114-
400110000112201222121120200112022200112221112201001222111200111002021211122010000020222202112002012102222201101210201210010221120022110000220221022014-
411220122221001211211021112001012021220010200122022100210121202000110021211200112122110111021001102100222200002012000100020212121212102000202212111214-
411111122010001021211112021012112112201202112200211211201122102201100020000212221112111120112112100000222000210211010200122222020002210021210022112214-
400211112120011112002201220122021212012002111121102010201012010211102221101221202101121101010110202012001222101000201120021012102002120202200121200114-
412112000201120202011002111101101200010112002110100212201001021202200021002200111011122010101201021222022222101212110101222101210112212200122121222224-
410012001120011022220012200122001012021021122220221110222020220121221002012220120101222100020010200202110202120012122221122020221101022111112002100114-
400212102221221000121112110021200122102010000021120012020211102021111220112221221220001210022112112201110212122020110121021210020111220101122210110014-
412111201112111102211222202121022101101210012100220111201212110021101201020021212120111222101001022010001110212212102201111000212020002212011111020024-
400111211211102012011212021002120202002001210002110110010212212121110021210112021022010021020101102022111010112022220122220012101120002022200201220214-
410220110210011111102201121022202020120112100021211022101201020121100201020011010211202210120112110202111101000111210000121110212011122100200111120214-
410102202101012211212011211000002222222220121122212102121012211102100200111012102000110010102101211200001221001100002112222110202122121012211011010114-
401102211201222221012100100100122200001002201012012211010110200012021201212210022221221112220102020200121202212120001200021220101011101011202001000104-
422110020011012002020121200112201010021212102100101101202220002101111012122221202220211002001220222212200022201221002211221222100001201011121010222014-
421201122020002112202100100011020121212201211212010010110010102222122021012022002122212112222121121220202210021222210002002012200101120201021211121124-
400102112111110212201212210212100022112100220111010220101101000002012111002002200211112221221012002211012102020111112001201021110200112201220112201014-
412220212222111200022000221110012001001102211020001200112021021211012110121120012110211021001211222022202120220001111100202002012222121111100021022104-
402221010220011101210121112020022220200212211200101122220120202202212122111022121212102121202112101222111220211112020112010200100201100120021122221224-
411210020021002010211210111210122001222100000210011121021202202012011012012021200110220201100202112111021101202110112020102222020010010002000012111104-
411201202212110122020222100021102022021122020200222201201220010002002121200021200011012220201212111011111102200121011012021200111220020010221122102214-
400022120201102200112010022012201022122202202111210202111110200220121121122200021211122000111010001002112220020000111222112110222210221121101102000124-
422111022211102002012201221111201000210122002122120221201101102100002200212212002000210121120000111211011000202012111120120102022201010002111011222024-
411200200111200111202000010211020120112021001210212220222201020010102022101001022011011210012001012002100111020120112122210022112010111122111221000224-
402100112220122111200211212201220022122002102221122200000210020101122102221020012112111102121021001022002010111212112020222001000202101121010020001204-
422201020020122021200011002021102012202021111011221212111200212011112111212002121021100101112100000122120011111101022221011000201111021020000200221014-
410100111211200211212111101211210221122002220000002010100111100002211102210222001001211122001212120221000010110222021020121210102021020110221101212014-
410022211021102020200220010221012120002000012222100111211021102002200122012112220222002122222000120002102212122120021221110121111022021211221001202204-
412201210111002012212220000202222022000121022100202200211012010202011111111102101011101110121202101222002212001001021202221212100001222112122121012224-
402012020102212001020002112012010102020200112102021011212121111122110102111012022202222122122001202020211012021221010100221122102121122212010121022124-
420102200221100211202201000011102010211200122000002001200100120221220022202020210000001211020122220022020002202120011201000201022212002120111110021214-
421121202111010110112110021120211022211102001220012001100020022122200212122100010020021111221000021221020211221002210111001001010202002000101012222114-
400200212211201210101121101200101222021121112221100112102022002002020111010121222002120122010111122011002122111102000200120222020102002101222200222224-
420122100112020121010102211010201021021221222110201111112221122002221012021100112212022002002110120111022112200101011210111100022122000002020222101224-
401121122011121111020220211212202201020010120001110120022200201221011101110210020001122202000111122100112010112112211100020211220101222102201020000214-
411212212022002200220212012202112021122202201020100110000011111001221110120122021010101202101101120002212002220200021010202122201010002202200220020004-
410102102021111200021020212110020100222002120112101022102101112222222020001121010011001210102211011022211110122220201202121012002122022020010012222214-
412100100122212201010002121121102201102201020101202022101022200011221001112212102210011021000102120121211202002200110211011100121000001011220100112214-
412011111001020202120200221220212001102112011211121210110200221002100220000210021220111001002000021121010202112112221111101120021120121211110201001014-
412212110001221002012001011220201110211110112021012102000101122001122200102211022202201020021110201112111200222100200222002122211000222012110011110124-
422210101222011221021111011010220002010222212020120110212201102000020101212100021001020010010211202201120200120211001212110202221021021201122001021124-
421200112200210101121101112210212221001222112221210020102212102102002021201112021000121002221200120002110001121111112201220122001022012101221001010124-
400020021021122211101010111202022220020222222100110100012202020100222111222111002121010122121002220002211001122201111122002010222221020102100122002004-
421021112101001220202200200000020112122022201100110210112221212110100010210101000010000220222011100122112111002012222120000222202011120202100201210014-
402220001012222112100011021202212022112220110100112211112021100020221001010022022212221012122200111110210102210001201100012222012212210010221122222124-
411210220220202000001102221102211022012011101210102000222012202102221110002222011100221221210021122221021220100122220001111102210022012100001120210114-
444444444444444444444444444444444444444444444444444444444444444444444444444444444444444444444444444444444444444444444444444444444444444444444444444444-
