788888888888811111111111111111111111111111111111111111111111111111111111111111111111111156-
788888888881111111111111111111111111111111111111111111111111111111111111111111111111111156-
788888888881111111111111111111111111111111111111111111111111111111111111111111111111111156-
788811111111111111111111111111111111111111111111113111111111111111111111111111111111111156-
788811111111111111111111111111111111111111111111111111113111111111111111111111111111111156-
788811111111111111111111111111111111111111111111111111111111111111111111111111111111111156-
788811111111111111111111111111111111111111111111111111111111111111111111111111111111111156-
788811111111111111111111111111111111111111111111111111111111111111111111111111111111111156-
788811111111111111111111111111111111111111111111111111111111111111111111111111111111111156-
788811111111111111111111111111111111111131111111111111111111111111111111111111111111111156-
788811111111111111111111111111111111111111111111111111111111111111111111111111111111111156-
788811111111111111111111111111111111111111111111111111111111111111111111111111111111111156-
788811111111111111111111111111111111111111111113111111111111111111111111111111111111111156-
788811111111111111111111111111111111111111111111111111111111111111111111111111111111111156-
788811111111111111111111111111111111111111111111111111111111111111111111111111111111111156-
788811111111111111111111111111111111111111111111111111111111111111111111111111111111111156-
788811111111111111111111111111111111111111111111111111111111111111111111111111111111111156-
788811111111111111111111111111111111111111111111111111111111111111111111111111111111111156-
788811111111111111111111111111111111111111111111111111111111111111111111111111111111111156-
788811111111111111111111111111111111111111111111111111111111111111111111111111111111111156-
788811111111111111111111111111111111111111111111111111111111111111111111111111111111111156-
788811111111111111111111111111111111111111111111111111111111111111111111111111111111111156-
788811111111111111111111111111111111111111111111111111111111111111111111111111111111111156-
788811111111111111111111111111111111111111111111111111111111111111111111111111111111111156-
788811111111111111111111111111111111111111111111111113111111111111111111111111111111111156-
788811111111111111111111111111111111111111111111111111111111111111111111111111111111111156-
788811111111111111111111111111111111111111111111111111111111111111111111111111111111111156-
788811111111111111111111111111111111111111111311111111111111111111111111111111111111111156-
788811111111111111111111111111111111111111111111111111111111111111111111111111111111111156-
788811111111131111111111111111111111111111111111111111111111111111111111111111111111111156-
788811111111111111111111111111111111111111111111111111111111111111111111111111111111111156-
788811111111111111111111111111111111111111111111111111111111111111111111111111111111111156-
788811111111111111111111111111111111113111111111111111111111111111111111111111111111111156-
788811111111111111111111111111111111111111111111111111111111111111111111111111111111111156-
788811111111111111111111111111111111111111111111111111111111111111111111111111111111111156-
788811111111111111111111111111111111111111111111111111131111111111111111111111111111111156-
788811111111111111111111111111111111111111111111111111111111111111111111111111111111111156-
788811111111111111111111111111111111111111111111111111111111111111111111111111111111111156-
788811111111111111111111111111111111111111111111111111111111111111111111111111111111111156-
788811111111111111111111111111111111111111111111111111111111111111111111111111111111111156-
788811111111111111111111111111111111111111111111111111111111111111111111111111111111111156-
788811111111111111111111111111111111111111111111111111111111111111111111111111111111111156-
788811111111111111111111111111111111111111111111111111111111111111111111111111111111111156-
788811111111111111111111111111111111111111111111111111111111111111111111111111111111111156-
788811111111111111111111111111111111111111111111111111111111111111111111111111111111111156-
788811111111111111111111111111111111111111111111111111111111111111111111111111111111111156-
788811111111111111111111111111111111111111111111111111111111111111111111111111111111111156