444444444444444444444444444444444444444444444444444444444444444444444444444444444444444444444444444444444444444444444444444444444444444444444444444444-
420100022101120200100021011122012102211100100010200221111010202210120011212212220001201202021012101211201010122220001212002021221101111202220111012204-
422102112010110201102120121021011200022200011112012102010202010221211222120111210202012210200110122000211020111102111012012212122201122100221012000214-
420122100111101020212001100220012021210221202202200122201110002210010210102220101200110020112002022021112011212122201100212022221122210202110022111114-
420212111011220210201100110102210002212122122120122222111202120212222102101201121102021120120020001201121011211100010111202012100010110211111211002104-
421011202100002222211101210010000100000201222022221221010220210222112001002210120110211020001010102210211011101221122222010011220212011110111210221024-
411122120011222221012121102120102111022001100220000011000221101112101010211220001220120101221022101210102020012110001001212221212101110220021010200004-
412201010221121011012102220112222212221012100220102120022111112221210110121122001222201100111010121122112012111120101221000021111020102000211220012014-
411020210110101122112212112121022211202212001001121022210020111222121211012102021111020200121012101011201221012101000002120002020112111101111011121214-
401001200221000102101102212212121211001121110211101101200011112021222000100210201022002210211001021202121001222222211111120122211101022011211122212224-
400220201121212021110102012210021200121011020010110021000021121212110020021121101211010201020020120122112002222101022221202000102022022201221202020214-
402201102002100222002222221120222001221012201122120022221201011000000021122010222112202221210220000202000222202220021022122022202200122121102200211114-
402112100011212020001112220111002220002210010100022121010012201212111022000100221201100211102000101102012102021022121020011211110210102111200012011214-
411210010220021110101112200112101100122200020202022101212002222121212020221112200022112222120202000201002010222102220020021111112212102220210010220014-
402200201201000220220000220021102021111021021020121022121002101201122201120112102001121222112221211010201110002122001101001010222220120121111111011104-
420212202200201102212011120121000110220120021102222001110000222210011112112012102211002020012102212222221122021200222010220212220100111122202220122204-
401002111112010020201111012122012212012121200101120020102212011111012112121102212212200010012222212112201201111012110211202222000220221021111220110104-
400121111000011202222110222222102002001210112100211210022212110201020201221200201101101000121020211222000120101022022101002202200020110011000012011214-
422101012111011022012200021122211022022122101201201012210211010100020011121002020120221110022200102220112101012220120121020122102001112100202100221104-
420201022121011022101110001001220200200210202212222212110202220222002112101200110101001011220222202211112200111200220020021010020121011110020211000014-
421121001220102000112022101002021102102012002101001102212120000101222001212010001120011011112202000121212022110122202221210100202202222221102020111114-
422201121200100012211101021100200211022220001011201202000220202221011120220111202001222020112110211102100101111101002020201120222110102002110212021004-
401121100110000001022120221120220021202110111211102101002200021220212111200012121101121121201011022200211220100102021021000110022100120110221012112204-
401220120201101111101210101020101112200110101200110101201210021111121011011201202122111220212222120221102021110110020112212000012002222020001211212004-
411021220221121211111021121111102121122211022010221110222021101200102120010022022110101221211012022010122010000012101211201120102001120200122200220224-
410120121200001010012100222001110000210020020121102001012112222002212100011201210010112022011011001011202100200001220010211001101221121201110110101214-
412121011201000111110101010222122200002121110020002200101112012112111111110100110222120000010210200012021020020100220201010101112111100221222021120214-
402111102011112212122121201122112220111110012100211022100120012101120100202212111220012100000221101200212202220001022210100112012221100112211212010014-
402101202202002212221211122021122010101022210210010012012001002121222001111221001022020020201210102100022201022101222220211110200011212112122112022214-
401201221112121121211101210102202101112200022210122012000000211010212100000211011121021211122101221221101121020122000212010120200202220021220222211004-
422120110000021120010212120211120022020012110111122021022020112100210102000101012002111221101220220200200020122220201120211021001112002001010020111124-
422110102111012102220212020002220121000121122121111120201010000020201110001201201100221120121111022000000201221022020001202220012120111002220202120014-
411010221020020221100000200110120210012101020012122111010011010012022212110121021100211210012121120122111222102212002100222211220222222000111212011014-
420221222022021021210011220101202101222221101221100201120021002102100022200100001221221100122010021210121111020201020121210021010202210121122111222114-
401021100121020120102222022201211012222212020220101010021000210202202000102010100221122120102011012202100021202011011211102112002212212002100202022114-
412220021220211200111022210122212100102001120200111111121211100002102202001122102202001211111100022022102020012200020112100120021122201102121110101014-
422020121012110120200110000000101111211000121000221020120010011210100121020111201000122221121222120201222120021201112121110210110221221202202011111214-
410120122110120210201112211121210020201110021121112011102120222200212000222020221200000110101222200122111111020102222001211020021100122022012220000104-
400110010221001102001202111211111222210021122100102100202101010110010012111122201110011020100202010200111102010121111102022211010022121011012010022224-
420201122100121000202001101121210021220122012102012120212201212100122000122000100120222001121212202011101011202200222120012212000212020111100121011104-
401211021202000002220200102220110210100112212120121011011010220011200201010120122220101102002111202222102111020110011010211211100201002121112002220214-
412021211102200002011122102012012021222102222112121021020102120120012012210011011011010221210002200000110011120100122111022022001101102011012212210204-
421202112210120210002101110201002222200010201202021012210121220220001010010111001011011201202012210000221202220221210222111100000021121222021201211124-
410121011020102002102201002001010202121100221020220021120102201101212120101201210012202101100200122112200002001100222220020001120012211202100200011214-
412212201002210200112100100001022002010221101102012200102100022020100112221220221200122010122110021101122012100110000101120011122100211020121012001204-
401210211020102020022220001012112021111222210022110101222110102220112222100020111010120011212121020112101020002111000022022201012212220110211201222014-
411010012120212111221121202210010021210201000201020221010011021112001110011102112121202021222010210210121001022001211020101020210202022222111112222224-
422020000021122200102010102121210010002012001122102000222101021112200110200212010201210200111111221111012111200221011002002000122211121220110222021024-
411121121010122102110212222021002202220120212110010221220110012102012110110021101002201222211001002211122021022100021102022111100122122202220112112204-
444444444444444444444444444444444444444444444444444444444444444444444444444444444444444444444444444444444444444444444444444444444444444444444444444444-
