444444444444444444444444444444444444444444444444444444444444444444444444444444444444444444444444444444444444444444444444444444444444444444444444444444-
411100100121211102120020211211002002020020010102212210212000100010202120012120212002210110222111002002020222102000122200010021101202110122112222021114-
410120220202010121201202001120212200120020010022010112100020021022000221021212222111011012021021000010220010210102022210200001221100120111122002000224-
402210210110111212000121100211121021110200122200201112001022200110000121110111110212122111000001221201120022221121000022022210211201011222120121212104-
421221122210110222100020120021212020010001222002101100010210021000221200221111201002220220210000010010001121102001002121012212120210021102010120110114-
402201001112120120011120101222011000211112222110212211020211201211011122002010222010210101111212022221112112121121101122000121121012020011012121121104-
420121020201220010012012101202210101120002202101001002112221002110101202102111011022210200121112020101202111121000121020100222112201201220210210202214-
410200212211020002112220012221011102102120211201120012121210012211002212010020010111200122211012122221111200222110101110211021200201011100202220222214-
400010102210101222120121221202202222210221110122221020011220120110012001110212120222010020111202211120021110212122111102202110002202110200222001112204-
402111200011221211012102120001001000102212110012022000000121120201121011120011221202102020222010101212010100021012200011100002212001102120202011222124-
402002111120120110100210220201202010112110020120020001022002210010200022200002000202020202220101202002000001200222101000222212120211122100210121111014-
410101111210212201211012202210101212121110111012212112001221212120001211001210120021112222021200000111001020211220100001201102010122102100002002010024-
412112222220011121001001222111001120200011210012221211200022200210021021200110200100122201110021122020021022120000101121011121001112200220002112101004-
400201212221202011121011002210001010012001100200111200021111220022021110110100111012212122222110212020221122121100100220101011121122022020021210010114-
410110212100221210212202220001201222210221021000010120221201222101011120002001211202222011212020202201020011212111010211212110220111000022200221012104-
401102111102102120102012222121202220212100220102000220000212021020022021100200102110111111121210202222200202120220202122112011010122112121101120211024-
401121012212001021102100002201222012122211120202222221010222002222112020221111220222012100111010210000221212102021110110211101112201100012200202112104-
420011121120021111002102012012211210121101102122002011222222212011201000110012211120200202100201012111202121202210011112021121122110010022010100212024-
401101010001002020121221201200210202021111212200202201111110122222011200202001010200022220122002121112112112021202001221110010021201210112002220001204-
400000122120002011222221122101101111221221011201211122210012202112210001022001102221112120120202110202221221102222021001002112120110220111222010120124-
412102212210220112022111212001211102120110021212202201102000210012101112211122010121220012222021121010000110021220010110001021102000020102021120022114-
420121210110110021001002012101120122202010022122000111202011211221001111220112110202020201000100021002101012002222120010212200210122002000201012121004-
412201110001000102000222000012001202002101200202102111110202211002102112012020200110120101220220010012000112010220012011102112102110202211021200222024-
410200121100101121202210021222022222102211211002220202020202200002210000212012221122010120201111000002111111110201201212001122010022121212122121200104-
412222201202121200012122222200000211020000101112210022011002020220001010111001000020201220202102200200000020011000200201200100112122021212210201102214-
421001121211121210121221002222110100101020211012002010122010222221221212021111012202200200011220202001000020202202112000202211002222110010221020120124-
410000221221110120212002022110220001202221201000100220012102120102100112201011022210101202010022100021111011000112202101221210101222002211021101111014-
421111002102221212200122120110021222120002002020220102010010222122012000110001222121210120111001200201122120222010111121120022112102012121112210012204-
420121210201212211010121110100202211120120001210112212200120221111021121120121022102212000221110022120121202221212021010002001112012022021210212012114-
421212111211111112220202200211101221011020002012110012022010000110001221100202201012112121111021222112121210202100201011110110201110121222001211000104-
411022101210120201121120121021122010212211121200200210020202202201200011102222220200100120102122001112212220100021210022000100002002010010000022011124-
400212111010000102012020012121212000012202110201111201212210020201110021111220100210201222101001022202211222210212222121020121112221002020221010022224-
412021200021101102121102002102200210001020212222021200221121011211111100021122012000010112112212201210210200212202000222020101210002110022211012221104-
411101212102012021000102100122222002001000101102002102022102010010221201200002110221220000122101202202200112222221200221010201101200201021110201221204-
410111000020111101101012210122010120112221120021021111222021112011122200002002121100012222010120112011110201221222201012011001021100100120022102002224-
402010121112202011102010110022110000220220120110101012001012200210010220220002121022122120200001210112221022110200020012021121202022011200210200110214-
422021010001220011002012110212010021011022102102120000121202021200001121210020012111000221002011102002211110012122112011021000112212011011120221121024-
400101202122020021020011121101101011222200022102122211020000221210111220111122020101202102011221221000022202222110120000210011010210222122120212220114-
411221210102010100020022000100221020121001102012002110211101220102200222000010101000121110010210011121222100020101221102021021212100000210212001220104-
411001101200222020120201100211110100120101121201002122112112010022112011011101200021202220110110210101110211111101110112011201221022220021121010112214-
412112100112002101211222112111101212100221101012202211112112000101020121021022120021110100211212221021221101000220022211001001121212202001200102100114-
411221021011010121220102110101220222011210220101012202110000120210002002112100100212100222111001012011110220001011020102111111102011211111012021201214-
411101201020221202220201202202201010000202211021121002202112122112001020120212200121221011210001212102211010200211020022021002021020110220120201010014-
420202220020111221000000100022020000000200112221222211112002000222100112020011121210100221101101111121201110201112210012000110121112122011011020112104-
412111221022002120220011122222102020111102121200011110012021101001121120211012021220201202002021200011021221020012201021022121210200021010222221101024-
420020211221201002111101211201001011020012022000021112110000010122202020001112011021021020211001110000221211000222022102211101110112012012202200122014-
412010212110012212112010010201220102200210011000222000211112001010122212201202220210001202010121011102120202202002202202021102212220201012001122020004-
401020210110010201212200110200022120120110222202202211101010011121120112002220201220121201002220200211010002120200202002011010110201001102120200022204-
421022011101112121020111202101210110120021220112200120020022101011121102222011112202210012010212200222121212000101101222011212011221022002221002111224-
444444444444444444444444444444444444444444444444444444444444444444444444444444444444444444444444444444444444444444444444444444444444444444444444444444-
