444444444444444444444444444444444444444444444444444444444444444444444444444444444444444444444444444444444444444444444444444444444444444444444444444444-
412211120101011010001100110120011002100122111010000001010120200220211211010202221000211120102200122121211002121002112222002021201021002021111022100214-
412120102201010221002002122202202011001122021122221011110112210000110100202210110221012022111000012120010200122101111111120011110110001222002020002224-
400121001010210021012000012102122221211120111111121012012112110212222120101201010010111210021210100122202012020211110021101002110021111002200001211014-
422222200012002100012220012212121020011122021202122010010120102120201122012221001210220122122002121110201011110110010220212011200112100021011201020004-
421111020220022200000010222012100111010212021011101222212122202201200210011111002000000002212220121201102201222002110202010012121122212100010000101224-
411000211112222121022210011210211222010101111210201221202000210120022102200020000020001012101220222002000110010210111202010222112210111012222101102104-
412212202210100012010001021112112111010120101010112221010001100221220112111222101202002001121000121210110222220000110121121212001101020000012200202124-
400210220102121122110020011222201100011212222222021020010000010100022010200200011210101012101221000122212110122111111201111220112010220000001010122214-
411100011221000220201002002101001222221022121210120221221121122100112200120122202210021110212012111122220112120201100210210220022101221210220210020124-
420001011011122001212120021210001112101110112110110021022200010020112112220120011222011211101010222020020011020101112220022210011020021220021112000204-
422022121110221210211001022121102000212011112011020012011200211200211212022222120221102201202001010102211122002021112200102220121011220220202202020124-
402201120002220012102202112212101001010120102021000022101021122001122021120011021110202220112220221121010200210100020012100121211101012100202021210004-
400202001100112001201000021202200021102101002022211100011112212122102100212002001202112211111211101212110210000120120012210201200010200202211012101104-
402001200222011021221121200000202112000121100200102211211102202211221011111000101110110121101001011021210002212211011020100212121201201011020211100214-
411102220222200111012012120202002202201021100111202101000220122010020102201002001100101122121200122011201001100012001121200011022200210110010212101124-
402221200000021110200200102202120201212000220101022112211220201020220121200120221112012002201001112201022020121010211102022001022221111101102020112024-
420221111110111022012112212110022000122102200020110120012110102012111021111202200100000021011001110120120120202120220102211100021221200000220112112004-
410100220110221021121121110102021022120022211221011110111210211211210112021102021001001010100111212121001022122111112212000000200120200210111111222124-
401212111121112010112012002002022000002111010220012020121102012100110210011012122000211012102221012001210011221100111221011100211111000110220202002004-
410120211201210100002211202020110220022000221221200200220102120210111100200221221112121102111001120221221220201220021000021002100202101012021112120024-
412220000122021010122110222110122000101011011120211020101111012022021101202102212100112100102022011201102001001222002112101011102012002211111000021004-
412002210210012022002001102200010020112211121202112111012220022201102210102111022010012212210100020000122120221210012002012110222102210011000000000124-
411110011222111222111021010001102121200212110111100201121022001111001122120110011122010122112121210011010100220022101001010021202210112220202002222124-
421110020122210222002120002121201000121121120010101000010221201101000121012010021122022211210100201110122010200220120020211012021220021000111221021014-
410001212011010101200221211010221110121101002010122111011200000111202202111200220101201120120201121001201001000000220020200100012020222210000220021214-
422221001122002201002020120121020112001121102100101012122022221010001110220100111202021102101022122022202010021010122122001002122101220012110220110214-
422212200101210020112222020112121001101101120211121011010101211021020111122020202212211020220100122100110000021001211001110021021221202212110022211104-
422121100222121012021121101111211120220110020111111212002011002221000222122112212021112022002222002012221010010220020012221200120002200022120220002004-
402110200222100001011002221220122111020200002202002001202001200110021222210210221021110000000212100210122122000112000000200110101111111011122110100204-
410210111201201112112122201101100012220021220000022221010110000212120220110220220020002022111211211010012121122012021220001200101221211101112201010104-
422101220011120220220221112002102200021011012010001120020202102211100021210111102212122120020222021100011200121112100001120201200221120221212211100104-
422212220212021220000020200001020022220012012202021211012122102102022122100002010001002012020000000220112200102000121001010212000102120010110201102124-
410200221011211111222111001121220010100110221221022001122102000222120011000012020022012121000002002021110100220211011102011121101220222012020001020204-
400120201210022011011010112121212120110220111010221020102010102020210210202112211012201200001022202010212210211011022211220221021102202102120110022004-
411100100121001122001210122100021002102212120200122211101110211211112122012012122022020021022020012220221212112200121021100102000022221210101121200214-
422102110210020121102012220111222011112112000211211011000022010211210211111002201222101111001221110220101012021002100002102010021021101000112122022224-
402010021021011200010002001020121112220201022012211120202221000102022112100120022002011220000120110011110001101222020111021101122100122012000001121004-
400110121010001200021221000210012211120011020102222111100201000010002021122220200020102112102201222110001212200220211021001220111011120010020011022224-
402202211222102021201101101101112212122102102221121001112222112100220220021000201222100202201212220200001102010012101000101120000122112201121012121014-
422002020010020120202012101112212101001001101022210220011220001221222022002000210102222220211001102020110002002202022200111221202222212211110022010004-
422110121110010020122220212111221011011200201010220020100212122122221002211210011000100210011001000110201220121211100110101001211011110012010210011224-
422202111021111110000210022122101010020010200102100112212200112200000200111210111112110212201111101010012220202201112212010201102210002010100112200114-
400021120220212002022111201010221201100100202121102221001001002101020101122221120200021202121112101111022011021122111122222112121210111122222112210024-
422200122121120020022020022212110201022211121021002102220222021202112212200021220222102122112012021101122002220101201011210221220112212000112001221124-
402101210112122102202102020110112221010120010111121200022210102001110000202102222012202011002020221021100100221210022011101212021010201220212102022204-
420110111122000020002012122000210212210222012202121202221102000200222201221202021020102100121012211012011100102221002222111220122211010000100022121204-
412002002012100121201100201111012110102000001010200120101021121020121011101010112102101212011021100000212111122122111222212022122220202201010221220014-
401110220012021220122010200101212022200102020221022222220001001101211201002202200111201221212221001012221101001110000121012202122202000222111012220214-
444444444444444444444444444444444444444444444444444444444444444444444444444444444444444444444444444444444444444444444444444444444444444444444444444444-
