444444444444444444444444444444444444444444444444444444444444444444444444444444444444444444444444444444444444444444444444444444444444444444444444444444-
402000020110101200220002211000012220202221200222000212212010111000122200201100210212101220112012022220202120220111010220010121202210212110000001211014-
421211222210122022200102120000111110022211001200002011020200210102122122222021020101201021012210112212200020220110101202020212222021222020102201121124-
400012210000211110122000001020120101021011101210111022210212101002211110020112122102001200020020112100022022100212111110120211020110111020022122202114-
411002001002010022221001221121112111121222102022111022010011210100200111020220010212100021221100212100202210200000211120210002202122011120102022212114-
411210001112221122122211122122102200200222222211212202202020110200120002000122000220211110122122100101100111211020122202210102010202102001110222101024-
421211210002021020110010121002101102101220201022212021221221101020001101020102012102202210020122001102211121002110021100011122201012111100212010212004-
411000101001011212001201020111202012102012102121012110210121210221111000210000121202100011021222001020012012021201220220020001120100101202202102120124-
402110200110222112210210001002102000210102122102011222110221201222211100120020021021010000201220120222120200000100002001210110000220100012122020021104-
422000201211002200012112011212212011020220002122202121010112200010100222110122012211122000122110000110011121021122122001110001220100021001211202202204-
421121201201200222100201220011002010001210021220100221011000011022201212111212101001121202210012221102201001122201011201022020101022201012121022112004-
412211020201001001222110011220202022112122100220220220002110020100010000111012212202222022021201021012021002210002112220112112220222122000110122210114-
411200211002101202110211201121102002120120122200112010001010000020122002120120220220110100020122122200011021201000202020211101022011000011101022220124-
420112201100012221102121210020200112212100202011012011000200022202120001002221021210012200110020012101210101222220011012121200222001201110120002101024-
420102020101211220220101212202002020001010102121101100001221220021001011121110011201000020210210022011202101000200000121211221120011211110010220222124-
402012110121000101220201122220022101020200000211001221122022101020001200022200212010021222100102101021002120012211020001102211010022112211000121112124-
422011212100001012121102020221010222011000222200111222112210110101112101020111120002120002210012200121112200220222121022220022202202012100100000210024-
412111011221001010201102001000102211211112122201100120120110121112222001001011021101212112210002211220022201220112021110022120020001122220102122010004-
410212022100201200120110002002021120212100220012122122211210021121111011100010222020001100010220111112122021110021120110201100020201011100112110012224-
410122201222122012210221111201202200101011102210110220201122222200121202221001012121202000122221111201220211222111120020200010121210010102000002011204-
400022020020202001211021220122221211102002101021000100211022211001101120002000112211212021101111210121022211000210110220202010021100222021002112200114-
410012211202011001120101201210001100010122121221122022002010121210110122102000010001220122120012102211021021000220011122220010222102011100001220112204-
410012201110122011021110221000000221112102102222102011210000122121010202202201202112110012011110011100011221112022012211111020210001110022000220212204-
420100211110021222001120202120210221220010200222122121110200121102022202121200100122120012120102000002201022202111001202020220020012010011202201202024-
411212111211102100101200022000011102200122011122120201002021200011120201010112101120210210102101011221110001111101222111012222212222121112120120012004-
401122222212002122121211102202011021201201110020121120000111222211110000102201110210122210122212012202002002220220101011110000001020010022201211201124-
410221010101002101201212100201012102200000012000200111200000010211220011221200012002020022111122122002200112020001020111122021000101212022201200210124-
422101210201200222200201000210002222120211210121021202102011011212010002020111201210000020022220202011221210201202010021211210121200111221221111210024-
401202221022220000100100001021210021121222021122012122210211121112021100111100101122201010002000021000220202000201220010011010200020122222201010201114-
402011011001212012121020020201110010001122111002011200112210011202011021222012022010010120021212021220010110221020101211220202200200010110020001001124-
411220221201021011112212200012002120120122001211022211021020221021100012110121200000100202101121110012022121122011210220022121000210222112111201111024-
410102112200000002001021210221120101212121121122221121102111221221022212112010020002022101112100011012112222110221100222202121111212220120111100112124-
402100111221102100110112011210000222002021212221201112101212010111020010111121102202112200012112101121020200020112110112221002002100021202101121102114-
402021122221021211122020210222112000111120200021211201110022211010211010210212222100210111122022221101010210002210200222112020010200220001001110211024-
410220202211011011110012020210122001021000221212011211012202202121002202102001020200202121210220020021111201200002210212002221022202111210102122200214-
410200112002002111002101000020220212011201210100021121022010000212200120010211221002101200211201220000111012200111020210002021201202000200200212111124-
412001012201211002001010022020110012012022002210001201220211222221210001121111100121011020100100202020212111121122012001100210122021122202011110201024-
400212011112011020100112101220020220211021120210011111112020022200222120020211221111002112010222200020012010222011111011112210002012212220210012210214-
422000121002101201000220200111112111022202210102022112101101001210010121202212011220120010220112000201000211221222110200121011210111001212102102010204-
402020211101220210000010222021001221112010000012020111112200100202101111111221010220102012122212002021101200211101200102112001210121001021010000202014-
422010201012002211001200101212111120221120220221100201002210201002001012001221122212021112222210122112001012001202120122122201222121001012101221010024-
420201200011002210201101120221001222102112010111111101020102000110211222001010001202000012200112102102212112012102102001011011220202000021120001100204-
421220111121002110010011221110220020001102200001102020001112002012202102110111012110011001200210022222120222101102112122211020202010122201122222110204-
422201221102220012212002220102011201101210011110211002201222221122101120010021222001122211110022202011201000202022012200210111102102111021210002010004-
420101020010200221001101112000012220102120020211112021011012202100221010221102022120120001212011011112221101111212002012110020120021201102100221111024-
412221112022221200211210002222121001101122002102012200201100210212102220201002211212222202001212112210221201201010110202200020022112120212012120220004-
412202121211201202011210202112112111010110010121201221200122100121112002002000211212001002000002220000001200122222221120211100102220200221022012000124-
422221010100002122010010111211222012022211211011211100112122222102102020212220222122212200101022220001001100100122012000201022002212001210110201220004-
421111122122022011101101102200121202102122202100022012002011011012022101021120022220102210121011211210010202121212211202102222200101001200211222002004-
444444444444444444444444444444444444444444444444444444444444444444444444444444444444444444444444444444444444444444444444444444444444444444444444444444-
