444444444444444444444444444444444444444444444444444444444444444444444444444444444444444444444444444444444444444444444444444444444444444444444444444444-
402101102122110020021022222021001020112122002000122201102111002002210100001120000112120210111021022110112211201222221211211000022211010112120010101004-
400112020102002011211200110222112120010122110010212220200021220110022022120021011222212211211001202200120112010110110012120111011021222021010221210024-
421211202120121221220101101200120221121121200022220010121111221011000100220222202012012111021111101222010201021100120221110022020001020022022122001014-
422121110222002020112222111112001200220022101112110121201222111101111201212021222021122010202201101221200122221222110211200211102010000111121220000024-
422210121102221020002221012200102122111222111222221121012102111120201020221012020202210121021122211222120012110020220220020122021101200021010100100004-
412022010201011112011102022202012011220000211020202122202020201100011002102220100120021010101000020221002022211122012211000211211120211100220111110014-
412202121012101020000221100111102121112221210010210212202201100020111222012112201000222000002010021221002121122210220212010221112201110012112221211204-
422010000211122122021021011120001000121000200011101001112001011101022212002021020010202001002122121020102012222120001100121101112021111112021020220104-
412012121210011002022020112102222120112012200020022220220010011001002012012101002002001221120002120002200100101210001221011112020210210112102121021124-
420111122001122011221101121201000000220210111201022100202102200021211121211202110022112120210222001120110212200201001122101010102010011212110222010114-
411121002102012120112021002011022220200000010222201100021011212022101212100121012112201001011221221111010102010112102202101122200212220212222002120004-
402000200002022120010120101221000112010112202120002010001010020200222221220121101211122210202202021012121002021222200112122111001000122020212222110214-
400020212012221212102020120102212020002011212022121102001222122200210022120212110012202112000211020101012012201111121210120212021100122001202210200024-
421122021020101001222200211222212012200001101110212121212102101200102020010121121111111100121202001021020021101011000220020202222112202221211021111114-
401221002121102020021002211002121110020220121221002120102120012011111200202010221100111120020121212210200020211121101112011211221201012121212220202204-
402022112120200021020202120101121012210222211211111210021102111211200111100201011220221200110200111121220211111112120111002021202211011112100210001124-
412022222202112021122120112220212100112012021120012111201121121212011000021001120120122122101202102022011022022112201212010222111221020100202112120104-
402202122020212000122122110012121101110120102100012111022212101121122100022110010220021211201020122221202100012002102102021000111102010001101010210214-
400100001000012122022002010020002020012012002202002022100001222101000001000000202221110222001110011111010010210211002012102022000101221011211022122214-
410212220012020010110100010222100012220201110222220001111122022200011220202120202022001022200000211000202102220222010011110211021102000000200221221214-
402210021012110111111211011000002010101201002000010221221112222000001022121011022001011111221001120021212122000101010111021121021120010010222220222224-
421022200222122110202202110221102221021101222002120221200201200111011222202201212022101000022220112102120012120020202221001022120020000202120111202024-
402210201211011102010201121000210100010020111102012000110110202220211120022201012001122120100010111002122122002020211121201200220212001121000121221014-
421120221020000001020111020022120212021221220202221222200020110020101220001020110201012001010110002112000212210000121120012210000211222012001211110004-
410120111121002022011112100001010101121202021200210120121102211222120220100112221201000002200202022000012001210121000220110000202102012111111011022004-
400220202201001102101002120212112012102211012102220120200021012212222202110022201010210220012021221212101010100110000211111102020112211122101221020214-
412012210001001100010021102020120021210212011022200000221011111121012221002111011121221010111220000221001101212111202110010201221212022222100200011204-
412202221222211012122100121012022021121200112001121201201012200200100212221102012222022000110121022210001202210012002222011102201112120020220001102024-
412201011221001212200220010020220012001022102002201112102102220201002201201020020202120100211012102010220221110022101000020210022121100101112012222024-
401011010201010020100001210001212210102122102202101002001221111012212111012012020210121201221011212001011000020111211210012000001221222120101200220104-
422021121222022122201022122112202221202002101121201020121202012221110202110211200100212200200210021022000121012110120012011102210202211200020222002004-
422120201211212000110210100102000220000110211210221112121010000221121221220220102001202111121102011000112211022011110121020002120211201120120002021214-
401101221221112002220221020021102020201220022211100100201102121022001221201102020221122011100220111021212020111002101120000011101020201202022012110214-
420011020210210222100110011211202201220221200101012210200112111111112112122021110102201212210121000111200122120200022022201020101122100011222001220224-
421022210100022212021102022111222122012102012001220200102100000210000212112011120202112122020022010000012200022102220002210201022212002212201222020204-
410020100101102122111000121122100020110022001122201020210102122102200100210022111110212220202200211202212221100201210122121000201201101211002110202224-
422111122002121102122012210122202211112122122212121011112102101100212012102211102211000220102100012011202210120012011122202122020012202021221122111104-
411002222210102220020100121222000200202102221121111101201101011120021222020200101011101112220011010001220122120000111002222112010202001020011101010104-
422100110102120222021101201002121001012121101000220102102012011101210022100222122022022021121011210202010101011001111001112001201002221021112102000104-
420101022011222222121110002102002021121101021010012020202211010222111222122122200220112220010220011210022011000012120012211121101010200210210221021124-
400111000120201002210220221011012220200200222021211122011220010212202022000100210021020022222220011202001020012010222010011121121221210020221102100124-
402200102012110010110202221221121122200202202200220221100012100110221011110111101022011010100002200111000002200211102111022112100021110200101101021004-
422202121000001000002222121220120222212020222102102110111122012120222100012202121011121211211221101021020122112220001100200011021202011002121010222214-
411100021020101212120002100210222221221221200200012201211111110002000112010102101212112002100212111122001011101210012110122001101002212110211202221224-
400211212000120202212221122122212122200220110110021101220012000201222111212011102210102222012000011210102002020122101122201221222201212222212022202024-
422100222000222111011200111220120010120210201222122120221220002122020000010022010121000010221222122112220222002021011000220001202100111200000022200124-
422110111011210111111111110220021100022101101221001202000001202201002101002100111211011002211210100012222122212012201102022202022211100111000012220024-
410010222202222122000101201120120020020120021122020222001021022021221221210002220000122002211200022212002121101201220120212120220102210220001200102104-
444444444444444444444444444444444444444444444444444444444444444444444444444444444444444444444444444444444444444444444444444444444444444444444444444444-
