444444444444444444444444444444444444444444444444444444444444444444444444444444444444444444444444444444444444444444444444444444444444444444444444444444-
421212022122012011002210000211202102222020020222111022110020111111222101011010011122002002212210202210222021011022011012122112220022202010110211222124-
420200212112222100212021212101010201222020111112112112201212200122212011102112222212200212200011012020020102102221202111122101202111011112102022010204-
400102000202110112112212002200001100221012121211001021111220221120201120202210102111111111112211202010102202222222110200001011011212002200120001121114-
410202012012220120112021201112202222021022220000120111221221212111022200200110120020000211121010010102101121000001121210100222211220202210012201201224-
410211110201101110200200222211111120112101012102012201221111200101002011000201021101220111220200000202121012020111112120211100210001212212011211001204-
402202121222101200210200101002000002222112110220211012112220202011110020111221111001212221111010111221000000110201021021112111001012200210202001101024-
422001110212202022212220112121210210002101111210012022002221222000201210201210112101111201001110210220020221122210220122211111120020210012102201221124-
402211122110001200202010112021200021212001221220212112212121221111112111110001220111022210102220221011111001222000110000111211200022110100001100220024-
402202220201102010121110201222220120110102120201220222110122120101020221122110221002102000001020101011102122221111020221001100202012022021210112211224-
421100000210122010221101102220102122111101210112102021012210211010010021212100202100010020102012011012112201122111000220211200100010001000221022002024-
401220010201221210021212210201102011111122211100011220111012221222102020121200211122222020012100210221121221211111001122012221211000112020220201221224-
411102121202111210010002202021211101020002101021120021021201010120221222000102201212111021210122122110220211000200011201111121102110120112111100220114-
422122212100212212110101111011201212110120021112221111020122110210222110210220001221020000220100122001020122010112011012211100102102001000101000120104-
402001122210100212221221121222100001101010020111100001012210110112002212020220121202021202122211212200122221012210220020010100101212200101210020101214-
402001210112220202022122200111002221022102001020220021021201012201200120000222001212001110122122011121211111120102021220121120110012012110211021121014-
422010101022001000011200112011110011101111221100210022210200212102212112001101200212022202210110021021221020002011021120210001021210021221210112010204-
400002011000020020011211121010202111120112100212201001110111000011212222022100121201112100210012101201212001111021010201000011022101012111201200202214-
411021010200200120022001222201112020112002111220122102120021120202220222211202100221020111012210200120121122210020112102111102022012110102201221010214-
420102221012220112212221121010201112222010121002212011011111100001102102011101201022212000211122111110202101121020200220000001112010211101010101001104-
422102122002112010101210101112121011221200010212212121101020210000020021020220012012201101022012122211112201020122022120021111000111020221111022102024-
411021211201021201220201022020220112102222022011020020100001102212212010122011201022111112011112111202211220112120002020120002002112012122120212200224-
400200212120020111201211002111121212011002000212202000102010020120100122201121122000111011120211121220002211021221121200201000210120200220120121111004-
412022000222002210002112112221012112220212122102120021111222202202111221121220020010122221002000112021202221011122001000211201102122101011222121202204-
402110221010200012200100212020221120120002101121210122102011020122112101020112212022101202211120020121021211110210110222212220001121110111011002002214-
421001021210102202222020201212200112211100110011220111122001110200000120112112111200222011020101221211011102110011102012022020022221022220120121202014-
420110112210011021202200211102100020201222210122200122020020001211211001001020121112120220010020202002111211222101210100120222101221000122211021012114-
411111002110101102021122001110100022201111120100112100211011122110102201100010001110012020211200011212211121010012201212001021011111200212202212101104-
400220211110220010002001222012011100200122012000121101220201022022101001122101020021202112102120200121112210102122202200022121101001200212201120021004-
402222112212021022010122001121222101102000210201022022010022200200001200100211210002222121220002221101002010021022011112212210100221111102102200212104-
422111211100102012201211001012222202022112102200210000211021222212022002212002120212220112121211210122101021121222112022000210110022221011202102200004-
402200222212110122221020222122112001201100202001221221221122210201021200000020112010102122112101110020021222011221021111201021010110212011002111202124-
422201220102121011101122100110110010221100110011011002012012101222221000001222102001011002101220000021210210202020210102000120012002012211201221221104-
422011122200010112221011000101102212101102000011220110202111220001202202010111112020100222122212001201101002220101220101102222100011012111011012120204-
412020112201220200100120022012210000102121011100111120222121210200120021211112202111011012111110012121102211021112220110211111200122101111200001121014-
401211122110211011100210110102102200021022011111012201100221012222221110012112100010202201010221200221101012221210001200012000201211012201202122120024-
410201001022000220000002001200200110100101020202021021111101200212211201001100221121010100022021002010020102202021221202112200221120201001211211200014-
422120100202202220222211222122121010212122220000012221021012100222122012010220221110110100120220002102220122112202221122222112010201012210101001220204-
420100101211210021112102021220121211211112022212201210010020002202100210002012201020100002022102021212220111212000002201101012021122221002202000010104-
402000011002211022210100200200012222210022022222021202001020010000202112121000101112000010021110002222020202201010111000222000001010220220120100212014-
400120100210120012001001111112000112021022020021100021011021100000212001222011200011220120102000122100101022202201000022102122202021220001011010010004-
401212102121212121210021121000001220112200110011111212112220102000000111102000102202222212021201210200102020222000002202020100002122122011200001112004-
412000212121001122220120100112112102122212111212110101201120100201021112210112110121212100021120200120010101201021010112000021101120101020011220201214-
412001011100000111021122010220102021222220010112000000020220111011100100222012220122101002120020222222021211211121121122020212010101110210202212002124-
401212020122211012200122111020011122010220221202202101121011021102222020220212221102022022001012110020121221210011002220010221121200112120110111100224-
412222201102100220200211001101010102122220001222021021210211101211220212121001011212210100112202012020122120110212212120012000210002220010101001220124-
412121121102221222211120222110012111222201001020122121211021021022001011011202212100100222112012120021222000221100110000121210200021101020001202221004-
421202001101022020212001010002222200221100110022021001111110211022210022010201000002102120122012202012211012102002222121112220222000112110111201221114-
421022212111112111001212212112002011110010111121111221002112221001202101222111011011201212102222121100221122202200120120111011001100211122110112002114-
444444444444444444444444444444444444444444444444444444444444444444444444444444444444444444444444444444444444444444444444444444444444444444444444444444-
