444444444444444444444444444444444444444444444444444444444444444444444444444444444444444444444444444444444444444444444444444444444444444444444444444444-
410200101120120102210111112220210122000211012112110121021002011121111110001122110212110210012100221111110211200200022212121201021211002222212100211124-
422111212212102110101001022211201112011022220211200212022220121210111000211200120210011200002021020021101211100121222002222211202112012122220000001004-
422220212000022010012122122022000202100202221110000010120100111101002102120202012001220011011101011020101122020112110022101200200112220022001021210114-
412202201000111212112221200110201222002021210100120002110101201021212101000200002021212200211020200120221102220120102001210122010110121222201020020114-
412201110200110000220212022220021200120200122002220012112001010111212110021020001212121201202101210000201012022101211211020211220001001001011001200004-
422012012222000021200211100110121022000121220120222121121022020012201021001020212221102212112212200200112002200121110120110012122022022122122222220114-
422220020112110011110110022021002002110110012002211220200001201122210220110100001122112102210211101022210210112122211112222202000022110002011210201124-
420021110111202022221102012121120222110022202222200212010202011210111121112221100001101010021122122011010111011210212012010211200210202221110201121004-
401112102001112022010102101101020012120101012102022222111020111202021110022012011121101121101211101002201012000222121210002012012012222111010110100014-
400010220010010120202122220221002110120110201112122210111202020002212202222201222101001210111102120211000120012210110021001110110020212010211100112214-
420102212010211012200220012212000211202101220002120120112101020012210101221010020110100002220121020112220212010121110011220112112211101221122011020204-
400110100221111211120201112022011002210011120112211221000011220011102012011120102211010112102020022122021011111212200010111102020111020211220222012124-
420122121012012120101010020110202110220020110101010000000221111200220212202110110121100022202010120101212112011022121121010112211220211011101101200004-
410120100012210122111201002111102222121012211211012100022120122010220200202121002212101112210220220001000011022212110101102121220120202202002221111124-
402012101121122021022201002210201011020020002022201022220022212020201100212201112221121010100220010002010020211002220010201200020011101200110201000224-
401211121220011202121211120100010012011000012120202011211121001011121121010220011112020020021112011020122211100000202220002212001001120212202201200014-
421221100002010022202100212121221101221010201202221000012011220200011200020120122221112101022002112201200112021002001001101121112122220010121122210024-
412121000000112100112122100222102111111021201021011200111120212002000020011111101221020100110021101112022112021211102202111002111020211121200010000004-
420202001200202211020122110022001122221100022020012111101201020210011222200120110121201210111212022121102012120011200200122210021110201020001121102104-
402220101122112201100222222120002002121222010121212001010001010211011222010112020010022200000012020222220102000210011211010010022110020001020120002124-
412201212120021021101201110222111012222001011122120021221200122222102002112002011211220121210111100122000212120221011202101210100102212100201111121224-
412101221222010021221011020012102012001111111022110210112112200210212000021021211122120221201000110122122202001022022210020121201022011210111101200024-
402101211002011100101110101101001211112021211012211222212220122111200201001011002100201102101102110111122010101021111201110201002010202011221202102004-
421221211200112022202101012022022121121220101101102011122220001012002002211100021200220222010002121011121212010202211121211001212212020100110121222004-
410201111012210100122220210120111002021202202222112222112010112210001210121200022210221010102022120220020222000021112112001102020210022010110012002004-
401002121112220111001211001222001020101121011120012102200112011221112110100101101220011212210222002020212000100002101011220102100020201021002121110004-
400210001221122102002111201111200212220011012020222000020201221112220120000001201201200101102212210111202210102200112102122222110111102012101221110204-
401212012020221102211022200002010111121111112021220001202221011202121121111002002111222002222001001021112010020110212222111012020222112120021000122224-
421010211101110001222110000202102212000120201202022111100220121221220011220111002122100101211221220100100102210221012111020002200110000201101210210224-
421222021121012202011121012201010000012100222001112212220212011110022100022110101122001201002210112221100110222211210210102021111020112121120120101004-
401110122200201201221112012022202021102202200221001001110112201201212021112122202201121112122211010022111012120222211111101101212212022211101222012114-
422122220220021222001111120210200202022122200111121010200010000111101212221111112201121002001112121101122110022201120020220210101022011122221002211104-
411002110111110202221011201012211011200012202022000010200001212101222112201101211102200220120202100211012102202112121201112200002100100020101222111124-
410212121001102112211012022012020011000212121101010002002212000000022202002021101212101201001201022202121220122211001011121112222111112001112200200214-
402012222122010111202210101120221121221111200001102002222022201011210012020211220120100121110020110110111210012222122122020221120021002102212111221014-
411010201011001110120020102211200222221121102011222201121122102012212212010002202010202212021111211210100110102202112212012010021221221020121200221024-
411010022110221101002211122221122121110111112011221022122021201000000210122000002201010110001021002200222020020101021211200001220212120211210100122004-
420121122222200112020112202022101210202021021101001110222200022211120112020010010001112202121210122111201012110212110211111122001120022222221101001024-
412001011022120210210012102110221000212202212001202002012012021222211211102112221202002211002022022121200220112002100102222011200220210101111222001024-
410112112210202220222101110220222221110000222000010010211120121121102201221212200001011212122101020020210122221000021110101010022200220010000022120114-
422022220020021020121212202012111101200200220201202221112102112220021121001000112211112001202002220221110112120211202020221221101111222220201010001224-
420201021121101001202222201011100000220112120100011222010112122121100112002210000010112021221010012010201012001221222011110112101010211201122111002114-
411120110022120212110112210110122102211020122112012211110220112201022021211111120221101102210112210201100010002112110100201110112211101102112122202104-
420001110021120000012222222222210222111020112100000020200021112111000022202012102202000000202222220120020021202010221011102000200012111112220210221024-
420012110200001121122201202110122221001220110012000211122111000202120100210112200201102211211020000210111212100121110102102102201022202022000111110224-
420002211212010220222121002122211210222201122112100220111121020120022210011002011210102120010220011012011111001121100100011222101012221202020001020204-
412211211100201211012021000112000021112220002210221020202112000112201222012211201221012211110100002001110121111020100110111011010020010022120002120014-
411120220210100002202000122110020022010111112121110201021202010001101000100221212101001211120211000211102000002100100002102222120200020011001101222124-
444444444444444444444444444444444444444444444444444444444444444444444444444444444444444444444444444444444444444444444444444444444444444444444444444444-
