444444444444444444444444444444444444444444444444444444444444444444444444444444444444444444444444444444444444444444444444444444444444444444444444444444-
412122211222211010000222111202021210101100112122200012112120100001000010121110102221212121100020020111120002102121201222002110201101210112102222110214-
400212202002121020212121000102100112200022010210000001110102000222000120020112121020012202211212121111102020120000221122202000101110012110221122021024-
411220202211002020020010010201212102101200011100120100222010020222000222111012120120222122020011221011210221001111200020110121110222111000102102200014-
401021110111012112110212212120012010101101000112220102002100200211100000102202101101111201200020111120022200021112002210211000111022121120000211001124-
421100110110202221121120020021222002001212010002120211012212201122000122210001012212222001102121101102001010121200201102010112010202010120112121122004-
402010202022102020220010101211001021102001201221000021201021010112001112020120000002022212212010111012122010002022110210102211210111102011102000100024-
400112021101102000210200100211201022001100100110021100022010202222022102020011111011201101222211222011011212102210021212102012110100022211212101212014-
401021001221212102201122211022210010211020010002212200100221011121011100112001010010220202112020200100001222000110111210202011222002220100210112021014-
412200200212222210210101220120010201001121110021110120112102021101221222210000200100021111210222221202222002120212011001121221022202200002002010210114-
402122201202000110100122221100220200020221200101222210200112102112010000101010102101201022000010200120122202202012221000001202110211200222112102020224-
400121011100122221022110211101002221022212221100012200210202222002012110020021112112110002001010220201202002211121012211210202122212102010220000112224-
420111202022110112110220121022102212112122111022221000010002002022120210120002122121211022222110202011100112200212111202111020011202212122212101100024-
412020112101202112002100201121020022220012212212120102021200011011212211110211012222212012122002210211012001122000120011002100001200222120001100000204-
422012200020102111222211022021102101002211120212202001010110222112222112200222102210200002202021121112121221202212110022101222102222101221212212110104-
411021222210010022022020121210000212112001011020021200110201000201111222010002002201011001202011010010002202210022212211222022011202011211110200120024-
410200111021102000122222222011110212011110011220100201002122211212000110022102000221210212020002100220002111211202010022102212111022121012020112202224-
410112022220001100202210212111020012011220011122001200220201022211111011120010022210010112112200221020010201202000212221102000210212220220121012210104-
401221212200220200000220212220000110220021221201110120202000100101210101120112111100002020110102222211100100120220222021112112101111002120112000101104-
410200112222220020200100202021201011010101002002222101001020110021100211220212220102101121201111020000000101010122122012200000011212011200212201211114-
422110211002022121001122201212211101112212220121122002101121222202012002001120202202121210101022200022101211222201001211010012122220022221112000220124-
421120211120121122111100022220102202002100012121002110200222121120011010021021210211200012102222012010110120002000110100122011122220101202001200002024-
411021220100212220121211102010001202200102220112121011222110022002212112211212002210010021120012001221210111001121010221211102100021122201221001120224-
422101010201022122102122010222100001211220212011221020002221110112211020101211112011021122002002211110011002222101202222201202101210112101221221022014-
402011022221221020200222212121111011022012202220111012201220201111021001221121001002110010112202202201220210101210111212000212202120221112201010210224-
420112022210200200202000122211022212101202100011220021100010120012200120020220120011122001102110112222121000212122102022100122121220211101011202020204-
402002201220101221120111100002021020021211212101121121020022102211222020111201010211001010120011111122212020222111101001101122022222211010021010210204-
410220022122101101010002021210202102001012200212021020002012211110111102102101101112211022222000222112000121212020021021221021012202001102200012021114-
421102222122221002002202220200220122211000122112210110100102011000110012211002220012021200211120222120010211121211222210211010122201202210112102202014-
412010101221122200201220112212211102121012010101102001111012111000202020111211012020101200102110020120012102121101000020201112220111121011111000221004-
412102212102201010001012020021222021222100102000200110100220122111201202110002022002112012122121220211020120100122210120102211122202010011101110211124-
402101022211221201000102102111220010100102122101001210201111012121211121222120102021222212000002202222020010102010010121111210100100020122000101112214-
400011000212122221121120200101121222021201112200211010021022002212222100111212002112201021200012210220012011011110012200210201020020011112102211100214-
422111120122121102211221100101102111202211022212021011211221212012220211102101211110010202010201222112010022210011222200122211102212011202202021100204-
420121120112100022110102112201201211000112012202110221100111022222201222112000002211111210100220001200101222012010110211100102220120210222220001001214-
421011001112020002120202121202212002121212002110110010100102110112211100112222002120112101220021221220102110200110211001012021202022122211102120120024-
420021200102001111000101221022220202121210122012221101022002200222021210010020211112000012000022100221021100120100201111200201201110201001201202211214-
411022021201120220111110111021220020000012210201111211221021002112211220111100020120220110011101200200011000002212110200121000011222220211020112101104-
400211211221022122022121221020100012022100202201122210100011121022001101211101001000011002020220221202020202002102111120210201010100111120101022020124-
401202220201101110211212112101121212122101202112221022101101201000122102221010021220222101212002121210211212022220212001222120111010211200200212001124-
421121000111100212210100021022222100022011012120102200211110222210202122020100012101111100012221102211110101200212022202100220102102222101010120102214-
411201201212012102201222012000212022100100011001111101221022022001002212010110112202020101102200110122210221002121012100022120120110110212100200222214-
422121110012021122000112222222222021020102120010202210020121000222221200022221211210201121221110022102020112102022101012011201012202201010201201221114-
412011111012001210201212010121122101101222010221112001000022200122012212201101112222022222002112211220210022220212111201011111010120222100121001020114-
412022021202121022111011121221102201011211112020100221222112001212011012111112101220100120022122202210022020110211022022011200201111120110221122122024-
420011121112121100212112102101011220210212110211022001002102010121202102222100110122121012121120221121201001120100000212122022122101122001221110002224-
400000202102202022222200102120121022122111000002110022010122110020100201122100012022210220212102102011011121000110102220211011211210001012100110001014-
412112120002011101022021000010000100102021001020112021210110022112001200210102210011121122102012111112210121202000210202211212201120020122000011011024-
420202111021000221001021221201122200101000020121120221200002222201112022122020210011000101222122022221110211022022022100212122110210111211002200022124-
444444444444444444444444444444444444444444444444444444444444444444444444444444444444444444444444444444444444444444444444444444444444444444444444444444-
