444444444444444444444444444444444444444444444444444444444444444444444444444444444444444444444444444444444444444444444444444444444444444444444444444444-
411001000102012120101010220021102101202221021020100101222220211211000222221011200001002002202200201111001221020102001201021020201012201020121201102224-
411221101120120121001001012021020012111002001222221211010021212201221102211101000201120211011122122100001211001220000212220100210100121221220102010004-
401120211021221212021211110011100111022202002112121212001010111011101110210100100010101211020200222110221202020122112002120211220202110000201201212204-
421111022222102221202101020201221112101020020202102012221200201010001000102201121220011100001021021021112121020210020021020211222211121100211112112124-
411020021011200122200111122120001021011211011200102010001221222011221222000102022001202010100200200120101020000221011211022200221222102211122111022024-
400021201100120010210100221212212222222002000221122200021001211221012212222221200200111020000112021020110110201222101020221012211222011101212122112104-
401020011221220202122001212122022122222010200110200212212121011101202222210002120010021202211000122201020011021112002021102002020201220210100012200124-
422220222020221120122101020222110021012222200201022120022212021211002021102201022212021020002211010200100000202100010100120022111122111000221202021104-
400010120111001012121112002010212002002100101111210012000122202100100000120211000210101222112121122012112211010021010122020111001121112202022010022004-
411010120110101022000020001022002200222002100200001000012122100012212210201220010122020002000002222001101111011100112222221100011212122111211110211024-
420121121022102211021222212201101201210021101012112022122110002110220001222121120011212002020020102012122100121221220111112002110112022200002220001224-
400001100121000111002110121111200211021000011102221210002000022011211001021010021200010210221201020020111120201221120221121102100012111020220220210114-
422112211121101122100220012120211021120201200220012110112022111202020012222100200020220001201101002102001210122020112222202102010112022220112120001004-
420000001111102100212200102202200100100001122220100020202212002121001112210010122221002202212002022021112120110011111022101002221102222021121110010004-
400022022000101112220122220120000110102122002212012121221121020120212002221022020201120121010002101100112122211002020221112202101111021202100221002204-
411201112201022221110202101110211122101011120010000211000201121122120121202111111002101201222002012110210010222022220121210011202122222120221122012114-
400112112202001000000100212102200000021010021210022002220202121220211211111102200202222101022002222022022111102110011120010112211100202110020201221124-
410011200210001000201202002002121212202120010201111202121020221002221220011010011012110222112000000121212102220010100011011121112001110101112011222104-
421100112001102200201212101011200021012212000101022022111122012101100101012200022011221220100201112101022021122010212121210210201222112210000210101204-
401010022212022201102022111212000220021000200101212011101211212210102210202202111100122202010202210000101100211000102112000022102011120002201101002204-
412101201102121121010012120202121201200201001010100000111001001002100010222110022220201000220110022002000002012100121112020222111201111110121122201024-
402010112021002012110112122211120000101100201220220120002212000002122122000110110101012211210201120022011100220212111222111210110120201101100121222104-
411012001201202200001212011122002011210010010012202010210221100021202020202010011021001002101121222012002002021220020120210201112222110100011212121114-
400001210110212012212101102221122122211222222012212210212011011121000200111210200111122022010021000112200111021222001211210212012122011220021221020014-
402012011222220011020201022110201111002122200000012010010210210002202112002021122021111110211100201021020201200112022212220202101112220100202111202224-
402120002011200012220121001211120210201210002122210211210021212220122122022201121201002102110220220011101120212212020001001201110122001111202002000214-
412200210201201111012121010202212220201120112120021121222220200002011000012100222222021202021101202212211011201201012222021110120112100111000011222214-
421112012002112110000112111020101201202221000002010022212102101211112201012101102000211100211212000102201202021011111012112021101201011011202222021004-
400021212222000021020200100022210112210101001102121122121000112221000221100100202211012012001211221001002002011200212021212121000002212122102212210204-
410112000110202022000010222000102200101211222221002202221112220202122100211222111212200022111002102021212220121200100102000120112121000222210110220104-
410000121010202200212011212222000101200120010221021100210002011011002012000021022121200101202211011001221011022222112200222022110221220212122220202224-
402111012110020212110022202201011110122101212112001122121110001110200122020102002012201102122102110222022201100011111012011220122220220121210020001004-
421122011002120212221011001110202121002102200022220012212111210211120212012221002002120020000111201002100212111001222001210110002122102020210122022214-
422000212022110002022121012212021101210011200211120102012100201210020222111120212101211020000102012210210122012121020220022111021011120012122020121014-
410111110020002001220001212000211121220112022022102201011222221101212112021001120121200221021001002020222001210002212200102021000010212002221000120114-
401200111110202202212120202022212002102021120021120021021201000101102102011110220111201111112011201021201002012121100210012001202112120120012102201214-
420202111021102012100101222002010210000102120112120220111110110221001111111020200110101000001222101201202001101011121021222220112201001221112022211024-
421112221100000101012202120010001100001011101212020222101211202100212210220110212022101000012122210011222102021012212112000211202201202111112022200214-
421122222120100102202220212221011110121022011110210101202020222212110212000020210000200012021011121000121211022202112011122222010001112102102112111014-
422100122121221011110010002001010020222020201021100100120112100201211102120112022110222010022220121012111020120021011212012122020102101011101100020114-
412220102022110211101102021211200112021012202202100112022002001011012021101021201210100121200210112102011011010111021101022021210100121212200011110014-
422120110112020200201122202112001001121020112110012001002120120102101200121220201222001010022222020110111120022102020021001210201102211000012112020114-
411120121012021021221102002212002022121001201211011120110121021221002122122210102222010010212120110212120021200212202120021100002212120121220120122204-
412101222002212200120122021122211211001010112012100110000011201111022222211122121022222020111112002211201200022011220021201111101000102121020010220014-
400221122102101100111111002221000221011110122111121100012122111222022112002121202111002022022211010201020211221012222220222200220120200101202122200214-
401212001211022211100121221200100220012111110202012221210102100100211022001122022110222110112012102210121221112020022002021011220121210210221000102214-
420211211011211212201001212021222221210000210112020201222002220121210101001110001212202201211021000120010001000200010110222121220200022112021222010014-
422000002212112110102200112101221202221120021100000221201011120020121112212022002222021120022100020101022110211111100101200021100022102102222200010014-
444444444444444444444444444444444444444444444444444444444444444444444444444444444444444444444444444444444444444444444444444444444444444444444444444444-
