444444444444444444444444444444444444444444444444444444444444444444444444444444444444444444444444444444444444444444444444444444444444444444444444444444-
421202111021222220202022021021112202122101120002002111001222011021101222000001220121112020120100010111001201220022101200000210112011001202200100011224-
400220022122210001022212102020002021121010010011101020002012221000222200110210001222112012121221121111012112110022010002022000000210202210021100222014-
421121210221122202010122202200011011102002201122222121221001021012200222100012111221110120201120012010010122201102200012021222012122112111220222211004-
422021122001100211020011002212001012111101112111121122122002200212210210220110011101020102212111111012010100222112210222122020010011110220202102221104-
422020220000001220101221210001120102110211200202022222200222100112000022221120011102111201100121111020020212201122120021010221112211001200201121101104-
411022012020212220220221022000011100210112112011112110012102001021222122021222100121022022002212121022122202021112110112211000111112202020022120222214-
400210212001120200000002202020210120220011202121001110122010211020221111100002210112020201220210001010002021202211010212201211000122112002211012001124-
410201020220102022011000122111111202000021100020112201020102112112120102110111010222200011101002212020220011202001201222221002020222121210111221121014-
402011202200010201221210101002221110021011222020221022022110221210011122200002000111122020200102002021210022010110020200020211112110212201111100122204-
420001202100000102012101200202021220012221112121112110010210102200001010001201021221110111000111110201121222212222120002022222022212102220211110210224-
410012102212010210022211121222102012121002100121011120201221202100012002010200002201221202000022210200020010010000001111100202012020211111201020210024-
402100110121112000012021102200221012121122222212201101120020022022221100211222100020202112102201110211012010100210022021211002212221200110102101202114-
402211121201212112022022101210020220221222012000102121001110110021101112121101021222200000022010100111122210201212121112001220020121211012211112220024-
421122011102012011022121022002211212002202221201101220101102122012200120020111101122010022221020110010122202221121002202122220110122011002010111021024-
420201122102012220012111220010101211021000012200001021010002210222212000212000110002101220112000200221122101001211221021212002001100012122101202110104-
400112110210001202212121112212002001100221002220202102112021201122210112200011220201011222210121012010011110110221221100222211112100101012222210200124-
420012121022100001000222221020120011200020011011102222121122212102002021210011002220000211122121101102211210110202200110122202221112021120200111000224-
402012001202210212211212020121011020211020121220121222022111002121002102001110122020111221221010020111011111101211201202211000200211202121200002012004-
410201020202220100101002120222010011012221012210211202202122112201012021211212110102210122110221221110110211222210112200000220221021010120202102211124-
402122200001121101220001202010120001222220111002101020212200202020220121110022002010112220221111210112011020000010120220021202111202200102002021210014-
420000120020212010222012122222121002212100122100020110022001222202022110111022212021101222211202210220111010102202221222121020120010121120120121111214-
421202201210011111202102000002221122101220220101110001210121220122202210102002112201221201100012020112110100220221102211022202112222222002211011120024-
422100020022122020211222121111121010220201102002201212220011122112120112221020120012211111020102200221210102022110121100222121102100210200102112002014-
402102110210022210010211212010210100221101020201212122112000102012210222111200012210022001001001102110200011210021200110200200121001201120111102110104-
410000102002210111000202121211021101222011201021110000122201121120121122000022202221101111100220020221121112210212021012020212211000000000002020102124-
401111210102021021222200221210100212211012000211021012201212202020112111012021011002000111120111020010000122000210200001101020120202021211200120122104-
422120122121102221002201112102010010001220202102210101202211220211110111000010122211111112000100021202111121020212211022011211201110010112121210221214-
421001122000202221021221202202122021210200120201100020102020220012201020202002022002220210120011102202022122100220212002112002002122121102002200110014-
410000112111120010002000210121221022012210121111111202110100200100221022010101011212212222012200011222111121201101021021101221110112010202222200121224-
421000021022200022011100010021120221022102122001102101100011002201021211220122102112221002200021110121222212020210210011110012011001020012212200201204-
422121200020011022200121222110021210012221212020122100121002221101110220200111121220000012101102201102221202002210220002102122121121101011202212020204-
420001011222012012201221111021212121002120010012100112010011212201020100222022111112201101201010012201001012102120002011102110011110012010021022200224-
420110021210001102111111111002101020010111120120020021012012121020020200102200001011212021110200210210200210112200120010012222010200201210020112010104-
410112000211221100210122122212200112201210201220100212102222012012010101120111100021011210221210112122011200020222012210112020210100010120112101121224-
402022122221010112222010200020002212210120022122211010000220222022100112020221102122121120000121110022011100001111110111121001221101012220211020100114-
401202010222111020210201020100220110212111100120022201202012212221000121211102012002100200222200012100010111002001210122110211202220021200100112211114-
411122010011201002111211012111101000120221112120011021022201102202111120120212011211122021210201101010121110001022202222122121210220020122210001202124-
400001220102102110021121200101202000110020122110022010122101102111220200110001012201121011221210002100001011000221021020020201102202210100011110120104-
411022101112020212001020221022201022212120012022011000010021210202201002100001120210012010110022111100202021220101000210000021102020012001222011220114-
401222121201012000201201210000000021021011120020012201201011120120021021002000222202012010100202220222100221021210100121211002201120020022110101211024-
400010212120220122200000121012102210212112210210020110102012120220101220122222100201010000021001101001212011110011210120120000022120012110101002100014-
420202201100001020102221011020211121000000022110011122110112012010210001010112102201221202011002221112101101111011100202100210201010200022212111020104-
420011102020222202020101212222200102221202111220111002200102000201101101002021022210111220002102111002002020201110122200122222010212020120000211111004-
421110021201202000201022120212122110010002100100012201101202001121202110100010122002112012220022212000111201222220122212220220010021022001121022020124-
412120100001202121020221012201101021200012112201112222201211110211121110210111222202120212002222010211120120100020202020011202200010022012122111111204-
422200001012012121001200021110012221102211222220211020110112121101022001002011210122021111012200001222001210011011221201122220012002212210212111212014-
411200012120102101112120122120211100120211000100200011022110111000010112222000110022122122122112102121222000121101000201000000122020200112101022101104-
410221112220200211102200022011200112122111010220010002111101002212212021221020211121010112100202100112101220110222110211221201110022000020112021101104-
444444444444444444444444444444444444444444444444444444444444444444444444444444444444444444444444444444444444444444444444444444444444444444444444444444-
