444444444444444444444444444444444444444444444444444444444444444444444444444444444444444444444444444444444444444444444444444444444444444444444444444444-
401222100101200200222220122200210101202010000220022202210022022020102120012100100112001001021210111100202122001201011120122111110120000021201011021004-
412021211021020020000102021222002122202002200202000110012111102101211121220201020200021112212221222222211002121020022221112211022110212011101122021204-
420101221121112002212211222121010021210012222120210110212200200010010011200221021010002122012001010011121111012222022011100120122112202221001121210104-
401212012222120200102001000200221020201022202121101002222202201110001220101212100011211010022212012201011000211222221101110112100102121010022202010224-
412020021201110021210210212011111011110101202221110222112111012200211202122100000001111200202100202201210221221011112201102121022021112201200212011124-
422011222100222002212102122210212222220012200012200002220002220000201022002202120021001212201121111010002221021021000002012100102021022100100211121214-
421012100211120102102100202100221001211112002121020020122201212112000002222222100222210000110112222210201222100201211121122211000222102202122112111004-
412202202212110201211200020122201110220000002102111021100021001112010011212120201220121200022021221110001022110020000010211102000121111100102121210004-
402122112202101200012012120121111002020011220120211021211221002102020002111002102012121002022102012112102010001210002222100021211101020101200020110104-
422001011201121000121120012202000112110210220221101020122212000102000122020102211020221222002101120200100111100120110211012001001020210000220221222024-
401012020112212202220102222110010011200101022021011200120202200212021112102222001210221221110012202010220001202010220010101120211021002212020201021114-
422120202211222222021212221100201100210101022221122122102200102112220011112110121020012100111122010212002110120100022220010201220211122122111202221014-
420220020011220112021202101212202201020100102210200101022021101100102102011221002221102101201000221112101200221100211200020102221120200110021002222124-
402021102021202002201200111000022220022121221012000201210020222110220202022110122222201100001212011120010011020100012101111222112020202201211011220224-
412110121202112210212121020012020212020002111000012210100221122201210112200220021211022200112100001112200002220011001111102002212220020012122122110204-
411211210102210211111102220121001212022221121010120211220120000201020020202211202112200110211101101010101212201221221110001111212200121012101212112024-
422121122110220220220200221112110110210022111222110012111220120111111000210021012221201100210221200012221020001222012011022001101210001220200201002014-
421202220121101122010000222220201122102210112221102202222111002011000212020100110222000202000002212111111101212102021012010021102202112010000220220024-
412100111102121020010112201011020101202122202121112000211211101200122212102120210021210002201020020210210022101220000000010210001011201120201100022204-
420020100101000211100001110222000101110020020210120012202120111102121010021112021222020211101122012211102220112022220000002011102022020121120020200024-
400210222220211100110102210211011001001100221020000222021121201122002222201001122222220111221012200110210202211110122020221210000120200201110012012104-
400210022200110212212000100011120211121001011122011221112010120000100010220010000112121021211120111112112202111202021212201012102000222110022010202114-
421010220220022120022120011112001102210221202121222212002101000120011222012000020220221102212001222210120012210101202100200200110121111120011200012024-
400210221110111220002020212110220001210120200122110122110112221000110120021021020201212001210001111011221020202122101112102101112101201110211010011114-
401101001202200012202201022220102202222121122212122112211202210002010000001201212120222220120100120212010020022102122122112111221201220010102120211014-
422002111010001101021002011111210222102022120000022002022221110212102212110000112000022221102122002000020220212020001212121022120000200200222102001024-
402102020220220100002212120022002200200011121000101010100002111102102210210221112012011101221012210202022112000122001120121000122200020022121201011204-
422002000011010201220020021001002010011011212122201201122122211011212002120112201020211122202000110022110122120012211112200000001120212002102012211014-
400010121110202120012021010202001220112020102000102102202120201021102122120211212011121200200210101210012021001002020022210100002000222002020111021014-
410012112120222112011221211212222010001021112221202012112012221121022102211122020020222211011122211210002022112002020012222101102022112020002112000124-
400200212110000202001011110211001222111222120021210112212221002212101201110002222200121122110101210020020202220002120220120202122111121220012020010124-
421022201212212000110201111201022012212100102000202000011121002212120020220010202212102110120020221121210111201111221001202111020001001100212212000214-
400020012221221211020112110120202020222102212102110120001002121212020211112220010122220212010120210212222220202201010110111100011021210022221002112014-
412221120121100021100021222101222200101112121122212100211021012210001120200022001101001010001020221121212221222102121210121200102222220221122102021024-
420010112100021122200212101120211100000120021121200012021220020121012201211220120102002222212022001222222001121001121210221221121110221222012112011214-
401000220021212021221201212121100022201112120022122010201221100002222222221200112010022211112122000122212200210100002201102121002001001101112002021014-
421121102120000100102220211201221222002102021020020100211000111111200112102001212210011221022221110210220202112001010111011111100120020212102010202214-
401111021201001010201112221002202012001001211010011110020122120021121221211122200001102220022112110220101220221122100002001102202000022120200122012004-
421221110112222011211000200202110012021220002011220102202102112000222010021022120112202212021021020120021021212222210022102011111111002022220101021224-
400202222122012210110220202001022021101222001122011021112222010210100002202220211110020222112111012211222111211101222021002110211122202220002211020104-
421202100012121120221021110101212220201011010222101212110000010201121001200210120010211110021202212102221022101202022220121011201210110212012200201224-
420200121101200201020120001102022121000220100002220002212112021002101012101221202002001101102012021121111022121220010001200011220200221202111002001204-
400220012000212020002000222012222022122222221011100100202021001022110212220200112112100211222102201201100121222001211100122000112022201221001101120114-
420000220211202002222002122022212112220120202221211222102111202212202200102202111022100011121000020100111220002201102022202011021002211112010222221024-
411001102220001202110010222101201210122210121220111212111022202120210121220100112110201001011011121020102112212202101220222000100001122122010102020024-
410000012200122101102221220122200211201222121200210011020202222100210220001122121202012102101102110002211202110021110120210012020121021102020111222004-
410020222122102111201022102112102100000011002020002121100001120002202112201112001112122211010110221000002000110001002021021211211002211002200021111114-
410010221022200001110010001002012000121202102102201011112112221111212211100012121212122121112200212022112120212201001211212102000000000110222000200024-
444444444444444444444444444444444444444444444444444444444444444444444444444444444444444444444444444444444444444444444444444444444444444444444444444444-
