444444444444444444444444444444444444444444444444444444444444444444444444444444444444444444444444444444444444444444444444444444444444444444444444444444-
411220102002110221200112001222010121120112211220211000200212101012011110002022221020201110220112000101211012222221102000101021202100020221011212202214-
410010110111000010121121122120220021111112212001201122212211112102221211212210201002011202100120012201012222212020000221021022000100212211012110101104-
402122021101101112220001000022112100202022210020022210222122210122010020002002000201120111020001020120112000020120002211122120220022212000221212212114-
420021210000022211211111100111001200011101100001200212122220201200022220021121021001200022210210122211210022212010002102111221111020110111121110200214-
411010210001200212211000100020000200120000212011222021022212111002021020012020120210121212102121110120010120011110001201122001202012100222202111201114-
402210001111112000200212121101110000020122012120111102002220010100100021210102101000211202220111010112011201011121100101212011102012000002120210200114-
422121002010110220020001022000020220020202022100222020222200120010221012020120020020122110120122111221220012111021220022111211100220121212220110212214-
412100202000100200021202122002112220012210102111122201011021211010001120112210202101022200102012102221012211210101200001011110212010201000020112211004-
422111202220100221010200112222101101100010012211111112011102022200211212012102210120002022020110011100201010000101112111012122112111122122221101122104-
400101201022001020110222102112222020212010100021112012102011021011112221020211202112021202112012220212200120121100201100101021112020121221220020122014-
410002220100011210020121101201110001211222000102210120221211111200010000202001202011022120002201101200200212102011011220212102210121222020120220222114-
420211000010212122000002122222112221100000200211011000110212112001012000210211102001022011001122100022202020210110201022201121100100001010202210002214-
402022220012110222122211021201202220220012022012020111102222210012001000101012000201001002120220011110220022011202210102200112021000220020221100102214-
411012110112022000010021112222011111111201122010122010211011210100000001000200120221120110010101020221021211011212020020210121221021202022110120001124-
400110211010022212202120112100221220111102010110121202001012122010001202222101122110211210120111120022002220211122010210022001021121122220202211201024-
410010212020022021112020121210120122110210120012121201210021212000020022002021220211112110101211002000202122200000112122210110111110000111000120120004-
412020100210012210200112112022020221220012102001010122210011212101222022212102000002212022011002120020021211100201212110110220200111111101121212200114-
412021202200211202112100101202102220111021020201000020112001221110100001120210122022111022000200200101011101011222022200200012022222202000101010202014-
412102110021022002212000210012210022020220020201010000012011200202021122001102201221020210212110002020122000120001121102011200221111120020011020122004-
402112111102112121102122202222101210020022122120022110100020000110022120121211110111102121102020212200120120202022221202202212122110002121201022222114-
421010122012210220102211022220101112022111102121221220100121002100211021202100111101112102222211102000021021201002012002010120022220000112221010121024-
402022111122112020020022202002022212010010021012121011202001010112021220001021022010122211101010020212111110020000020220000012112021221221112101212104-
400101111000101110000201012211101210020101111001011200112210022022011211112011211112011010210220211210001102221101212211102101210010122011021020121214-
412221111011220102212222010112221102222221210120102122000212012012021201021100201100102100110111011202221001021011011210110220201200011210201221222214-
421122220112221112122120101202211212220102100100220002110121121121010010121202111011022102212100221222120021010202112220201122101011201121211220101214-
400020102001202221000110011222121201211100010221110112220020101010001100002011210202100001202222101102121101022211101102220202102211010022100020210224-
411020202222111020100001100211211121102100011220110121110222202100110012220212011001121020102020010122221110221201220010200202121200110221120022012114-
420101202222122101220110222200222010021112002202000211022021201100020101121202112220102222120021201211012210112121222010212220222110222022022120110224-
422001122212202210112001100221102022211020101001102012202200111021221121210110110001210120101210121112210122021010022011001012001112200121201102111004-
400201101010220011100000112102010222012122210121201200200120112121220010212222102111012211120210022110112211010210000002210100220102010201120210010204-
402120022222111021111001201002221211020012222121021012002101220220001220021122201102000121011021221120202201101020102001012211200011222011200121002004-
411012022111111100021012021122222201221011101110021010011211010221102200020112111211122111022011021101200111020220122010002220221102211211012012110224-
422202212110122111100012100002002211212112121101111222101001112112101202011200020021211110210102000001202110102011101012122121220211121021102212012224-
411122101110200110202011122021100112220001210111000202012221121121020012000001121101012221202210211211110120211220111101201121010110212101000020220124-
401111212022020201221220012001020102110110211001220102202122200012112120220120011111212112110011001101121221122022202110000212010221021002020221021014-
401010201002221210120101122201202022212112221222222110212212002021122020202022210110202222021000122021221221001011210110100201121212202111100110000224-
410101221021002220210100012200001101201221102000111212200212022122111210011001211112100011211012212201002212102220212111200000120010110120011120101204-
412220202121110211212021110011212000111011201222011201202112100122000101120102112201211000020120020120000210220211120110102122222101100211020200021014-
411010222020120221120222122220121021100202121020220211001111222101021112101201212122111020001102010212121011221202212012122101221011022120010122211224-
420022222221210201002021010012100222011110002010101122110221212201012012002200112021200210022000102220212001221220221020122202110220121102110010121114-
421111022012222011120111022202010022020122112220011111120121200200010011121110011111211011100012212211010210121120020201111222112111110221021012122014-
412011200111100120212222101212010202200020021010020121002222201111121210202211112021221021021222010110211201022202020021122210022221101110010211121124-
421012112012211022202112201201120210000001021122212010000002020111220122122112202111120102001101102010120111012202022211012221010200112001120120212104-
401221020110011200000002121222001222202012120212212212212001002220120122200011112000201102010011201101101122222221120200012011111210102112002021110104-
421110220000121211201122201211211002112221220220022210020202202121201011102100211121201202120200002000120010110220201222200001010220021221010102002024-
410010000201121121021112011101100220212111122201010210212200220110000222022221010202110020101201222212221111221000011220102201200102001112202121222224-
411112022012221210011010010111200222201221112002111020122100200220101201002210100011121022212210212221112222021211122011200102221120201100211201012114-
412220200111000002021020001022112202222102221110112222212100000011020222012100001222002121120002221010201110002210222102221221210110212122222100122014-
444444444444444444444444444444444444444444444444444444444444444444444444444444444444444444444444444444444444444444444444444444444444444444444444444444-
