444444444444444444444444444444444444444444444444444444444444444444444444444444444444444444444444444444444444444444444444444444444444444444444444444444-
420110111001210002012212112102122222101120100002211200021220121020021021010202102102212012021221021021110210120020120012012021101020101021111121220114-
422200000202000121100021222212002210200220012202202220101011002001201211010001101212002101201121112011120112100010101011122212012000001112202011111224-
422002101001200001102221110122221021020102020002110020020212011121100101010211111210011212212202120001102011111010002221121202211201221102121122022114-
411212102210121002112011122121201221202120201211102000221211221022012112221000211210210100002022201001121211022201020121202212010222111221222010222114-
401102010212202001221202120100011100010100210200211200202211200211210112120202111021202002011021120021220201000211102111010020021211022202100202022124-
420112020111012110210201110201000002101020110111122121211002011122000012020000010020002101111111011000121221210112121102110200200210012112101121012204-
420200202001021102121122111121001011211110002222211222012022202200101201012120220210221202020100200222111112020000021220221200001021201000021211121204-
411001121112022211100001010020211111110120102211201102120112011002020020102201222001221210202112111120012010021120002010110011001202122100022111102024-
402120121110221112021212200200012112120201201210220222101212101110201211201101200110200201001100010000011012201012021122110012001112202102001020102204-
402101022221001002100100120102221221121120010200022002012210202112222201120010212101120202012101220202102200122121022201120020001212211010022120112024-
410121110211212001102222201101112112212112001120021212200122202222102122011002101221200212111001122212211212011101201221001221221022201102011201010224-
422121220112010101200011000120021122020122112001210022120001021110200010211221011201010200112211102022101212211002120010112001022211022222000100101114-
400220020022001011012020120020221020100201112021120122210211201211001001002021100001120101101222112000220112001002111002002211012121011212100122220004-
410021000211012222021111010020211100102012102202001210001220110110011202212112010201120221121011122220122001000111112200221121002222222002202001200014-
410012202221102212101100112111111112020122110221210200201210020122112220101010211002111020010121210102212201000212010011111102211102100002011011102024-
401121222200101022001100010212112200112201012020121211211102020101120012111100202002222012222022212222121202012112200220021001202101112110200210000114-
420002101210010220010210022102110022222002100010120022102122112120210012020121210011122220002211200222112210200220001202012020011120221202122102122224-
410011120102001022000021112212200102110021020021212012100220010112210010112011202011011001220211211100112020002222201202100002112210112122001201210114-
402110001222112222110022212221122101102121200102011221102212101101201011021112100222101212010211121000110112121112211021002112221122020211011222221114-
402200122112210211221001011200100010101211011212221000200122020221021112212111111220100002010022020220210202010121201012221101020211102201122100002114-
400121101200001012111221002102102110210200000210020001212110020201210221221002101210222200022222121201120200111120100111212102200102201112201111002024-
402001201002000112121201220001021002022010202110001202012212110200010110111202222210221202021001100222112121021221120010120010011110221001111011200004-
422020110112102100111101202122120112021102111122222200102211121210011000210112201110020212001201001111202101200001121001121122222012001110010220021014-
402200210202002012210220010200010120111011000002220012220211211221120012210112102220112000100010000210011101212101021220111101210120222022020011110114-
420221010120011002021010121200011022101012010000001002010021220102221100121020201010022220102101110212010020122122012111211120112200201222210021101004-
410122120000100221021012021012000221010212101100210010012212021010011122111102121121201200012022220201000012120001101221002001210120011012212122021114-
411220120020010010020011202022100000200110112211002001122221220101112122020100022012200112020122211102220010122001212021222200001112010002201212021124-
422022200020212120012111010100221220122101101012122202211110012012220220221000120212011211000002100201100211002222002200010212101222012021121201000214-
422001212020022210010101202201112020210010212001211121102101000222001112102002012112100110202022021102101121202210121210022111221011010210001100220204-
421101120022200011100110211101022010002022101120212222010021201022201200210010222002011111120210222122210221020011120220201010222010022012000102111004-
401120222020202102012012011120100012202001022202202000012021100021100211122011111212010022022211212222101020020122202110200021020222212101201221120224-
402010011221210111102201211111202011011022022111122210010211022011001012221120210000022101112212022002211111020202021212120022011010222102121122201104-
401001002002020010011002101111110020011221020011210000110222022122212101010120021110111202112121220222221110202111102011021001222111110010000220021014-
411021020100112020000200000012210122211111201000122101211100112102022011120020122112120200220212200200220212010110210002000020100021212121010202010224-
420022111002212021221021021222112001122012121120222201120221201102002222000010212021010021221110202020220011012101002111111011211200212101122002021224-
412011200121010210021211221012020121121001101110120022222002121001000020002122101202020211021011001011102002201020201211111022120010001220100121011004-
420020112121211101002111100211012120221212001122000020212122210002112222011122102102100220110020120212022001012102112021111011001000102202011211210024-
402002202222100020120101002100222221122201211112121112010002022222211102001122002200002212221122000000122012012021200001221112121010200000120010101104-
421200222110021110201121120002120020000010012012101102111220011020111001100111202211000100022211210222112012100020100222212021210201000211100100112224-
402120022000222001010020101200100001001221122002001011112101111112002002022200122210012212021011210120210012110221011110202001001220111100210212012214-
401122201221002010212101100211110100200112000011112120110022222011002210112212200200120021220212220221020021012210020001022021211000100120101001001024-
421112002100000112022021212212010222122001200000222000201210000121110012001221100010200202212120120100120011111212222112222002221020122100112101111014-
401101121222212112202001112110220002101012001102102111020011111011021022222210011022211112020211001111000011220202202220222122110212110210210100210224-
410112201202122220101120012210202122100121200120022102211212100202122112200220222221121002210001222222020002022200010021111012201222011000200111000204-
420100010101220200000120020100000022220211210100100110101222120011210202111112202202211121011200112101111021222110221112020200100010002212201112000124-
421110012120212022022111210102012220001201200111110012122112011012000220010201200000011121002011010212222021210212020001100221020100110112020122112014-
412120122110110200200221012111011020222122020222221022211120010110012000000101121010011121122200222202210222101020011102211112000210010122101201110104-
401101020220200211020202201002022120122020202112212220211221010202011011121120222201200211121122021102000100201101021110021122022122121010221022002204-
444444444444444444444444444444444444444444444444444444444444444444444444444444444444444444444444444444444444444444444444444444444444444444444444444444-
