444444444444444444444444444444444444444444444444444444444444444444444444444444444444444444444444444444444444444444444444444444444444444444444444444444-
402220211020011210220122101011120002212211202211122221022222010122101010002112010112010202022000212022002201021202220202212100202102221121001222012114-
411010010012212212110010100120112111020021011101022202022001111010021220100200001122111211220121221102020221211200121212001012220111210200200120211024-
420101101122121100020020221010110102202220221221212122122000112211001202002201222102122102220100201121202001120212211202222021122121211202212221212024-
412221010201112011211101101012000210000212101202122200212121101200112100210121102102020012010122221112021001110012112112212101221201002020100111001124-
422201211000111011112221200100022002211002210201202212222012201102122102010222012020111201121122112200012102011002020220202102001100200201201221110124-
411200221001112001111011002002211011000011021102020200100210110002120011111120000120012201121012020202220002120011010111221221222212201211222020121114-
411102210022220100111102220010222210101112201110111210111200201122200110000012222221102122000010200011121120112020111201020122212011121020212201122004-
410020020222212200122102012120212202002200000201121220121020110011000222222220210000020201112002122202210102111201201012220210212111221120002102012104-
401220201011022200112202112100212222012211011221200111222212121012222000021222201002102011221122211121121010020000111200100212211202021222122020122214-
411202202021202020222121121000021111102201200022021221222000202002202010001200210022002112121100200000022212012110101001122111111011021202221201202024-
412000212022000100120201212012112222221100210101210001020100010010212111220121012110200110002020212222212020101010221100010202221221212200200110221104-
420101010122010000122110100020010112010022120211200200122220200200211201101001202202201022122202022010222221012112012121000212201202102102212211121224-
412120012020102222221202102202020101020202210002011011100210210010010102200110221222020101220220222101221011200002202110111010022102201100012202200004-
412111211102100020212021222220000021120010102202101012002020110012001010121101210110112202000211202220021110122012002011120012210122021102110122102004-
402010120001200202200001111201002000010011100002001100220021000010000101201010122202220110001111021010210121202121022011010010120120121011221200210214-
401202121011110200021111111220221101200120212200221001010022100021000002001220110110212022100200210021001001211010121002202012102020011221012210210004-
400111210010011102200210112110022202212001121210121112012120011210121022120202212212112002222001221110212210110110000121110210121222212000211100021124-
421211201221120110002110200110110212200112011201002110012200021110110222122021222102122222120100011221200012210211222220121222000201202111210020202214-
400202212102210101120002001212120122012121221122202222210122020122121111101010120122210201122002112122010201012101021111021212100100000221110121212024-
401222220222101222021120110021110201210102100222021010021122020221022102222002121001220110121222100111121102211200111222102212122101112120020111122014-
412101012000102011122220001212021120021002002102210020001101001212112220012021010202110211200100022211121210002120011101200211022202002210200102200214-
410100222220012220120010200121102010111101020111012210202011210102220011201120120120022002200022101112001002112122021120020011021201220121021012120004-
401211221002022220112001112211021220221221222212111122202210101210200001100122210100000101022220102111112112212121110201001221112221122211222020200124-
421211120221121012020210021000202220102000110120021012121120112221101220001120102201121002012211100220200212211120012210000021202222020121202020011014-
401222000211112122212120101100112112000002001111212010010012102200221120022021222100201011220202010112102222122112012221012000111211001111010001210214-
412222122220100212021000001021022021001011002221220010010202220022211000221021211212002121221121200121000022012021100101120200111002102001112210200224-
411202101110111121100212212101112220020020100212111012000220212010201210201021202222202110220100111022011120222212212212121210021222012210020001121004-
422201022011211211111222120010121111002010101112102211101111102200000202220200122202011102120121010012221020102002112012220221020111112112211002220224-
411012101222121010101021212212202022011211211220200202120211002110200121010002012211111001100211010202212221120202101001022200102000100011110020121014-
421011001022012201011122022001212200200111120000210110201020111012011002212212210010120210222120122200221121220110202200001022110221201022120201210024-
402110201222221120111101212010002002211100210222102011111101121212110121221220122001122111201211122200010201121110022202010100210102110210120110001114-
411220101211021102122020022111122102002002210012212210020022222021201120100200012110102112122202021211020222210012011220020001112111220011211020211024-
412120122210121122002120121110020100021202021211200122220100010112100212221201222121201110002210012012022100120020102220011110120002100002201200020114-
421220201211022122201012110102211221111221121210220201020100201220220101212201101210111222121210020011200221111200201201221012002011222022200021110104-
421222202010222202202011110021202002010110002201021112221012102201220100021200110001112022112011111120021201011021202212122211200201110220022021000014-
402102100020222220102021202012100120202210110122201210002210002120021122222102011112100101020102002121122001212112111210211101100011202120222210220124-
402000212212202210002110100022002112121012100120112112000202012221122010122102020202010121222200220020202022012020200100120111100100212122022101221024-
422021111020122000122220012202011122112101122120000101020210121021202221110201211221210011010222002122201121001002102101112102020210000002012101120224-
410110002212120022012000210012202102020220100010112220212102020021212120210202002101210212200100221102121121122102221021002201002110000001120101212204-
411010200222100121021020222121022101100122110010220102010202202001110200111001221020212002111122110111111111202010210222110222200120022220100112101114-
421120022111121102011220102110212110222012000122001001002020221221011102002020112000001101001022202021221000022200112121021021111210002211101202022214-
401101021222011212101012122200210000121102221222022111020211220000221000200122211111220220122101201011202022212210212101100121212112022212100121110224-
421020222211120212220122022021001201220120202221001000110202212220010201221111220201022001021002020000022111221001122120112112112202121002001210222024-
401120022020220210000100020121001211121012200020201120022100112120001020121210211010220110210210001122112200020201220110111020000201212212112121001214-
400222201110100220210010211211112100000211212010200200211221121022102021022202011021202110222210000201001020011001210121010200101202212200201212101024-
420101011201011111000210211021020022202222002112200011002110011220022211001000012110220202002000201210022121110000011102121112011020110000021211111204-
410112212110021201212100211201010122110201102001201000102210000001022021201000221201102220201001221222212212111100222220111101022222212221020210020124-
420010201000002010211101110101001211122221111021101202222201012101101111120112110020010101201111122110101100202000200012220002200201211221202022120224-
444444444444444444444444444444444444444444444444444444444444444444444444444444444444444444444444444444444444444444444444444444444444444444444444444444-
