444444444444444444444444444444444444444444444444444444444444444444444444444444444444444444444444444444444444444444444444444444444444444444444444444444-
420221210011202210020022010020210021100201000220002210021200201021220112000222102102121201002002102111121220211022000002202010101002020122022202111104-
402212002222100101122210220102110110001212201201120101221000120020012220112200011020202120220012022122100220212211000021012201011212022121001220022224-
400000021120211220200022022000022100001220211210010022101000212011022210020111202012200102122100011111220101211102001001002221111210200011101020010204-
412211121100021001110000020011020202122022022201021002010211222011222002000222202200202212001021001221011211101110121101220220111002200211001222202214-
410101000210111102202202110101012101121222200200011121101022221110112012021120212010112202210102022100022001120220010010110000010210020220110121211024-
402121122021100202200000112102112002212022021000011200221000211000110121010011120222112200201021102110201210011011221202011202202220212211011121002124-
421121022021110102100200011212010020220210020200102022101220122201001212111120102011012122100011110011002011021011002102010101220111120010000210222014-
402102102211011110200002001112121102000220100020120022221210020222222000022011101221021102212112222120112110010010222122021200020201201200112102020014-
400001201102111210211012200211220120220122022221121200100111122020001102212120012000111112011020001210001110110011212020010002220001120021100010000124-
410110111000200012201000001001001202101012202212202122102112010210012101200102002122122021021222220011210221010111011100121120202011021121002121022204-
402012012120112122220020220110102011111221222201211200020212002020022201102210022101111200210101210012121202112000112100112000110021100121120110012114-
402000021110012212212000001002110022112010020221101110002111021012102002011021021102020012020000211111202110000112101110121202022002002022020020211024-
412110102101221100221011022201202020010110110222212221111200112021122210101111000111010001202112222101011202011222212022002011010011112201021220200024-
422202202100101120100122002110110220222001201102222222202021212202112021201201220222112100011121012201000002001020202120012121012201212000010210010014-
422102020100000122122211101000022120201022211011210001022200021002121100112110112212000111012021121210222122021002121001122011000122221121011102211124-
400012212221122122112112010202112022212222010120022020002110011120020010001112201001110220001222220121201020111101002020101211110102110222022101020124-
412212122221011012200102112001211121122012002200122111102210102020200021120001010220010022220212201210120020011202000102200010222221122222100111221214-
421022221122002121100022001122021211011200012202001122022020021021221100102210120001012222212121110210120200220022100201112011222020021212212111010104-
412021101111121220011122020101211010110002220001011201011022010020202122211000212010210110102012011122120020010211101100210010220012110200110110011124-
420221201121220221210212220022100000110001001222022100201002102202120210200122212122222012010020122200202112002002202211002121111121200201211022201014-
411011221021100001210112111201222101202002122101021102200202111001100002120122020211021222220121111202201002122101020212011222010202201020101022200104-
401020122121021022211220111022112011010221001212100200012121110120110111102202102101210211221101220101022211200000121111101012120011002012110021102124-
411012020202021210200101211020101101121002021111121210102002010201000101111110101022011010101020121100011011222122201012122210002210201201012222202224-
420010002122001201111212112112020012200101110011000022220102002012120210000002212202221102100222110200211211120220022000101012010010201010022222121214-
421121100200210220001112100002101121212122011210221222202101200121201112122102121201210221122210212110112021222222201110100011202120020210200102022114-
422212021010012120011021100111120201011121010210001000002121000222101020012201120221202222111210202110122202220102000102100101110021100001200102121104-
420001022221002121101001011120012222011122200001022202110021102022010010200120211201122011021210022200100020102112021010010101020221010110020112120004-
401111002022010222221000211012112022111002010120200020101200122020220012102112110112201021102120121001222012010112220212201020221121220111010222200014-
412110000111201211022112011110021111112011010121112001000212220001020100022102222210212001110122011101102011001012102211220002112011111000102120022004-
412001111021200200010212010100110121012222012002211221001022111222212021221102211201120122121021002211110010220021110001101200221001022221121200102024-
421200102020002211001110000210200120222011022011220221222111111021111212200021212221111102020021120001021102000102002101102122020211212102201102121224-
400221222002102120122110120111200001022101212110201120221210222101000121110100022021221122120022102112110022022022001020202102122100201000000001012224-
420222200021222122212000202112010122221211122121100012110020010022011120221212211212120210221100200011110000122210102210102111021011212102222202011024-
421102011100020111222120102121021212111002000000121102102202112022022012221211010112111111122211212222112002020010001110122010020021012200121111121114-
402002110200212002120011011002121210211101010000212002021011100022200110122111220102202000212222210102021121202101112110101222121211121212022111202024-
401020120001122000121222200011001212021211002201021201112201111100022212100201022120011010121221001210000120001211211101202010222110021201110110220204-
420122222011200200000211212022202102111100100002002111100212102202222221012102101000120202112021200201220020102201221012121222210221012202010101000204-
421200022001012011020200112021220121012200122011111020200201000011022101002101011222010000010201012210121220211010200102021022112101222222220012220204-
420100002121122100010021012222010201102220222220221100020022222101111111101010020200211121100110002200100222122100210120020122022111221010011222120104-
400102100202101110222110222100121020021220022221011112002101122022120201121112012112120200110011011112012122212012001220212211220122110021012211011014-
412201211210011211200020022021101002102112012110012200022002120010020020121122222102202202122121200001111101220002012020012211120101020102222002200104-
422100112212200010011201001000022101200201220200121112021021110012220220020012100111011112020010112012112101122122012221221102121121002101011211220104-
410201022212022100021011211011002221210110110022200020112012122010212222202102101110210221211100100122012000221022020221112000100110100101111201201114-
410211221100002221101111011022202202120221000001210212121212101100121212021101101211022022121211022210021102210200200222102112111020212010001210021124-
421112211021212012212220220222010012120000021121120010120212211001221200012000200000122110010112020111112110210221012002001210011221102121000010110014-
412112101101102202121101120221202100201121022110011220110112010012221100022010100121101121111211212222210101022101110220012212210011100000220111102104-
422112120011002010222220101010110201200111212100110200211000010201022021211200121210101010111000000120212110121120222110101000111120210002020222122124-
420221112111121220022201102012101010202202202110220221012101002210200011212220110100102102102201101112212110211121112210210211010100211220022211110114-
444444444444444444444444444444444444444444444444444444444444444444444444444444444444444444444444444444444444444444444444444444444444444444444444444444-
