444444444444444444444444444444444444444444444444444444444444444444444444444444444444444444444444444444444444444444444444444444444444444444444444444444-
422002110112220010202011020021021101122222122102210112111110101121202020112220211201201112000221110122111222202000212100101221110101021010101022012004-
400201010200012221211112110110112121021202022000212201221222110202001210100100201012102200022000001012210111010200121120120222210101010010020002200114-
411000010010212201201211111202200221220212210110102221210020021021001010201211012222212021222111102021000100010102210120011102002001210200220120200004-
420012012111221220121122022002102201101200122002010022021100200220001001220212122121021212210021000002211222012210222120010020001112021220102220202224-
420002011211102022100220020001010022201012100001220020122010211122210000212011210100222010102001112201202122121122022101100222101101200110220100022014-
422111101120102012221221102100012121002210110002021012200002101210212000211212112020000200111102222212010120001020210101200021100100202200000022101114-
412022101211010202101021222110200102002111220201020111111000122121221010102020102020102100212100102021022110012022101202221202110201012002002210211204-
412211011012210120220000112021001112012012112110120002222111101120121012112100010221200100102001222220110101022211011121101210200110022122121102002024-
422220002101022111001102012110202200012010222202222122220110121011212000211200120021120121200122102222210112210111211121020221010111121000221112212224-
411012022202122112221102220011101210012102122001112121112201001100102020200100012200010201021011211122212122002221011012220210221211001022222102020224-
400212020101001102222110012011101110221020002202212020201112010121100010212012100211020101020200002111001201000210211212212122112220102000121021101214-
420001020000100220210211012210102111002222111212102221020102021122011212202120122100200222201020211101222222122121212101202020012121211111221120200104-
421222020220220121221021102212201120220010212122220221220101210210021211221100001211211120120022121022010110202020010222222111110000000210002211021014-
421011121220201112100101002210221002102111020110022011011202201222202110222110001121021021001021220101001100221102212001222221002111120201011212221114-
400000222200012100101202211220110111022120110010100022212220101201011120200202012001221012002010221212102002220001121200011001010202100122110210021004-
420020102121201210200221001210011212201211011022222110011001221212221010020022102022110202221020000202020211101222002111222021111202212112111222002014-
412102222120222212021020220110011211120000010112200210221101122010212211212020201122122120102111222010011122012110010200100202021002112100201112110104-
411220222002011112120011010120201022201102120100121222212000122010120101101111000102211211102020111222002102112110110121122011211201110021121022020124-
420102111210211211212110111212010002102110100122222212020102022002020000211200110010021100122221122022222220111210112022020222221211211100122201110004-
400120221222001022010010000021021121122110001210002212222000222222111121000020220212212000012021222102111102121102221022220122210201022002211111012024-
411020111220112100100021201102221120111022101212000122111210222011211022101002020021100101021111202021002100201001101220000202110220112110102001112224-
412100020102212220210201110102100220011212220002200002012201201120122111200222122212021011220101000120122112020200102212112112201201211020210222210204-
420010121022011201000200212020112221112022000100211221002200012221011020100221220012000011100222002102212201102122002211220211211020221110102210202214-
412211011111000210122111221010001102212210100222110022002200211112200010220102222100020001122022201010111102201221011011112201211120020122021211211124-
422212020012201002001112220010201102112220020111001002222112222201200210001001101121220220111111002211111122122221120220210122111012012211120100111214-
420110122220201001120211221121202011220112022222010212122010210212001012022002100002102120000000202202101000010102120200001102212112022211210010021104-
422000120020011220211010201002100002020011020221021200112022201010012002212112220201120111021100020110002112011112100012011220212202001022200011110004-
402202110121022111210201021022202201012122112212200212220020220101022020010222211202121012122100211112100221020210021000101100101220001021112011112014-
402212020001102121220201211221220221120000101101220211012011010001012110202121222222011201202020220201101101101112020122211101112220010111201010020004-
401122122121111202020202121020002001012010200001121121221120211212201011122220100121111111112112212202021221210220202022112211110021120021210110222214-
402121201010021120110102010111200022200011221100121022012001010102111112112212002001120102222202011210022002011000220202001220020110020001100011201004-
401020212122020220121121122022112020201100022022021102002001212212020121221220010001111102220211212010222021122202201122222012100102002022212011101124-
400102200001200020212210112121202211121000001112020001210221102102021212120210101101010022000220112020110220012222002012120200211022121112121100212024-
411212120000020101000221201122200221122122021121121200000121220012102102221120200022221001202000111020021011020102021201100011202010220202102111220214-
401200211110012220000001021100110122120100121222101022012200120211110001120101101021102011002002220021012011100212010012102111021121002010010010221204-
410202022121020102002222211102020201222222210022200221002000210220221000120210000122122201212210110020021221020220020211100222211012022101022100000204-
402101211102110102201220020122121122022102011202100210201102200212001210222020110201221220121002022122222122100220222012100112011110101022211111122104-
402002202111200211000001022102010100021021012001212022212112010212000222212120200002220122101012212012220112111020102120000211110211011210111010102204-
411111112211200120201102210011210200222202120201120011000202202000010020201110122122110110101202102202020210011120202022112022022201021212220010221214-
411020202120012000102121211101120121010200012201001022211021211021201210200110010220102121122111101220221122012222221002220200012210121110221222122204-
411120010102012210000020201122120220011200120011212021212020202200002221200102211001222021121201111212022022102210220221111100220111222021112022100214-
401121121210122000000122200220210010101210121021200012101121210000011020000212102200212221002210010222111111201110111201100002220020220212120021222024-
420201220112000022022212000001202120001022212110000010202210020010020022000020211120111210010210200211001011210221210010010002022002000101100122012214-
400002120002220000122120021120120112001012220220110201220210101222210212022210212111101200222211012221202012210010120202021102010021221102220021222124-
410122121021002221000212010010200100222120122012120212110100220010111101101011010022020000202222211122011201120210201101221211220222110200010000211114-
412100122001221200000201202222010111021000201200000210011120020121112112001211200020120200220202201120201100211200222221021120221000020221220210201224-
400010102211111212012110011210000112200002221201012111102122021020022112021222202110112012021110122001120120021000012000010100001010211012001122022204-
402001022200111202120111000222001210022100110010012220200010001112110221200022201011002200112200210211012002212201212020120121201100011120010002212204-
444444444444444444444444444444444444444444444444444444444444444444444444444444444444444444444444444444444444444444444444444444444444444444444444444444-
