444444444444444444444444444444444444444444444444444444444444444444444444444444444444444444444444444444444444444444444444444444444444444444444444444444-
401110222010122010020010212001220212001102000102202110201122100010000011222200120121002000002200020100012100002011101222000021111012100210111102002214-
411102022120222100022010211110010202020121100011000120022001111121120011201110221001221020222100000101000101012100020002111110221212112001021120011014-
421002101020211121002012110220012220212112012121212222012112120011201001002121022121100202012220102221010011121001202110122010102110010102121022220014-
410101001222200002111100210100201120022012020222002012002202202010211110210200212200210001110201101201212200211002101000120022021201001112221102111204-
400022122020121210201220102112222212202111020000002200221002211020212220101210001122012121121201122012222010112002111001201101110022022200010120001024-
422112221122202200212220101212122110200212021011101011022101022200200111020021122122111000220202210221220122100020022122122011122122001022100121201204-
412212220101221012102201221220121010101122021221110012112021221221011012122212222120200110002121201020101012011210102000002120210222011102022012012104-
422211222112020122212210000201011112020212122221200121100011202110111211221202202011212100022201100122221202211002121200120000101102120120102112202224-
420021200001111022101011021201202111220121221102022200200002120012120020002100000110122222222200002022010211200010000220021112200220212121200021200014-
420022211022201010010001101012002020012122020020221212021111222110201012111201100221122101212020122122010202120022200201100111121012202221001110010204-
401020202222200120000222121211112112201101001112111110012202211210211101212010221112110012222210022120110210022220200010100012000012012012020202100224-
411011100022102211202212101011001000220000201112201020220120102210021020200100101211002020111201110212101122221100012112202121101212012100221121211104-
412100022100100010121200000200212211012010012121111200122011000211111222022222212120201010100000021102022111101022002200212100100221021010020012200104-
420110102011100110110110211111211200212220020001021001222210222201101210222002112220220111201222100210122022112100001211010121122221010200212112201214-
402011011111122101110000112122102012011121211201121110000211202112200112122022121100212101121122022110102122112021122111002022101022212212021101112014-
402221002210122101022010222112110221110212001211122020121120021222112011000211001210112010220201101110002111020002100122001111111210021110201200012114-
421011102200020221100221120100200121121121222201210200122211211102010120221122110112101112020110111011102210222002110011101102121110100222200212201014-
422102102010110010112201102020002110020212022101011100001220202010200211001211221121122120201100211122100112010020120101021222101110222211210122020204-
421210121111101201020212012002122021001112020120122202021221001111102020111211120222122012211200212102100212202002100121001200001001012210121100112114-
412010210001201110021200100010112211121210100012211021120212202001201021001021211122100010000121002020111222020120222121010200111020021222112202010204-
422221201222221020100111210011220200102120112122200010010011212221120211022120200102121110002201100021022100000211022022001020002110121012221120010014-
400200010201202020010102212010212110020202021122012012012200112221111212220010210001212102001011100010001212202110122202221220122210200001212101022004-
421122020000111110221110112000012102112010012101212100112022202012110002121111021002010211120221010122021011200110202111102012102221212110122002002004-
411111121011120121010011120222122121021000120121020201121121012022220211201210021111100200120022221120022212212121101020001221120102221121111212122014-
411111120110021021102221011010012100122201122101211020121201002111121121211020001122102201122111001021210100122101101120221102120210002100110021202014-
411202000200221022201121022010011101202220101212220101110002110111010002022022010221121120112211122211111002122102000102110002100121120111201101001214-
422202012121212211022210202020110211102120212212201221002020120212121110212011212002010000210122021221011210201011222011200121121012022110221202001214-
422022101200202211020012101010211101120210021100200012212002011212111212220011121112201220011221112010211020020212211211211210012010122102100201121014-
421111020210200110222102120200201102101012200111221101210110021220201001100221121012111220112102111102002221212102010102222220221202200102201021220024-
421010211112022211110021021022012200010201022010020122011210122011221112121101211212200102022121010121022202011121200222020110022001120111002022121004-
412122212110200122010110222200011220122121021210020012220100000202221022212112121011120001220111111220011211122220101102121002021202101201210021220104-
402102201022211021102022211011021010100200000000201210011110102012211012200110012111102120020122000212120101011201222102102222221210011020222001000104-
400102020121201210221121011112020220220100022022201221001202100121101222011020202022011221201200211021002021101110210221112010012020002122101022211014-
410221001122120011012122011022101220020000200200220102120022201002212111211002011101110020212011022202021112002222202122022111120011112201211002221104-
401110110101120121020012012221120002101122111101112122120100101222002122010002122220120120111201220202122111021221011200210112010221100000121021010004-
412010211201011011211110222101010001022020001022021121111001100111212202001211220210120211121000021112200220122221000101002012022212121010111210021124-
422220110002022110020200120212210010201121120122212101212221121122202002101020112120212121210110112120012222200011221022122010211200212202012101011214-
421022121222210102001012212111102010210221010211222200220121100120101111221002012010122010012102201002222001101002111201000102200020001110122222111124-
422210021202101011010212212210011210100212002022110011112000101001121202222121020101021220121020122102220111202102201102010002122211222222110022012124-
422211102200222011201112211010121200020211101122111222200200121120011022002220111121122022111001121002120222201201200011112002111210220120021211101014-
421212210110122201100101001021010120212020210022211022210021200211202001202121100011010201102110210010022002000122120002101121212212112220201101021204-
401212100202000002110121002111101200200221000110121110112000222112002201010011121121211212000101222122010220211210100022100121212002221122122120011214-
411110112222012021001112122002002111010010002001221110111201202111000002012102002120202120101102122101120110101212112112100121121100121102202222101124-
421201200210212220121020010201011021101022010000012022202200212012122100222222000122111122000112002020121111000021011101012201220002211222022010020214-
411201122011212020222211202011121201110220111121012000210202202122022102012010121001000121000100220220220011120222020020010110010002110121100211211024-
402211010212110012000111211110100122200221101221220210000200102122212111201120221121002002210012000212021220121010222112121101000002002121120122002104-
401020101220002210000102010222110001100120010012002000111211102120202010012121121121220221001120021002020222022010010112102000221020020201011211010214-
410102202121110220101011210021210211012121000121120011121120001020012100211111120221001021011101122222200011121112222111120110102212202120012212201114-
444444444444444444444444444444444444444444444444444444444444444444444444444444444444444444444444444444444444444444444444444444444444444444444444444444-
