444444444444444444444444444444444444444444444444444444444444444444444444444444444444444444444444444444444444444444444444444444444444444444444444444444-
401202011112212200220010110221211120001122101021011211210011000001000120000000000000100112002211121100201210211020212022000022102221210121002010112024-
401220121102221121222122211001201221210002112110021222022022221122221001120121122200102112010201201110020111111201122001002101000211110121002101111214-
410122211001221022202101002102112111102022122111101010020110101010122012201121221120000200000122221112212000002121211201100000022202002002202122122014-
411012012010000200220120121100102101121101222100002211122121001101211200220012111100000121111022102201000222000111121120011120201210022012020100221104-
400000020102000210012201200010212121211101210122101110102120122112122102020012112200220121010011120220021222202211110211122001100200221101022011022024-
422210111201101001112010210002200212010021101112221021110110010001100012020222112120011101212212022010021221012102110010221100000201122220202121222004-
402102202122121212202001112112021021002221112002122011102222212001221212120001100210012220021102220010122201001120111110010120210021011110212100011004-
401100122120001010101021202001201111200002201001000100120011100110201211111022200112211021022022120022022222200000201100211222111012201210212010212224-
411022200121022200111100000121200100121210100011101200020110100122200111112211110212101100220210200022200211100010120122102010022001022121221201200024-
401212111212102002121011120002011220121021021022000021222020021011200012122111120210010012121020202111010122102022020020202112020200122002100120200124-
410022021012101201221001122120001110100222112202122200201000011121020201002112120110221212111212111220011012210112100021001121011122120000121222220114-
402200102001210200012111021101111010202120000022001210102212011022201001001122002020102002002121021010221011211211210111102121101201020101011101012124-
412201102000011002020021212022112202011100001122010210102120222011110222221121021101111202112111222100020010001102110102101211012121221111221120112224-
412222021212001222022212211111011102201001101111112021022020112202112001200210111201110122011101110000101202110011201020011101201221011020101001120004-
400101220002211200122000100010220122110221221101111120100002012210102112212101101002010100210000000012112201201000212211221202111100110012221201012204-
400110022020112010200100221112120021210112201122212011002020001020220022221001101211201020021210111100222002010120020010112011200221012222211120022124-
422021120011221211111111101222110210200010012121022222120002100201112012121100212011110012120212012121020102022222111110220022110110102002221020220014-
412220010020202000000020212102021111010010002200001122200102012202001012202122021021211011102002022111212212212221201222201211210220201022011001010024-
402120102121112110221020222202200202111120221222011122100020100012120202112202222122201200101021201122212121122220102201222222101002121010220021021124-
401121001001202211010010221010012222122102102120100220021120012121020022221102110211210222112121212212120210110220210011222021100212112110010212200014-
401022222011021122011010220210021202002211022222002012201102000111102221002112201100010101010101002212001102112022222222000122020200210002020221201214-
401010121201112102202100011201100000221122000101120212220021212020022110220012011201211202210022111122010220221101011120010101012110011010111122111124-
400222000022222001102102211211010111220122210221221212212111201000110210002102102022012212022210221112102121102020120112101022122220111212000020022104-
412002010221211201110122121100101102220011011011201020101012220000112021002111022202020221002222020210201102202020102000011222000120000110112020110104-
411111222200012010111121211121012222002021020220111111202220121122101010102102100120100111222212002022022211201010001112200102112102200202202002012224-
412220121001002200221010012022211120200012100202221010111100222002211211111010211020110001101102212120111112022102202100021202110100211120120221211124-
421220211022210101002001011212002012221210221020020200022011112222201200112100012112111221202001202101022222111101101012121011000201011222121101201004-
400200101210000121011000100021110110012020120001121111102111002102111021010002001222220020120011220002001210122211220012202210221012011212202121222004-
411212100212222100011000211101210200121001001110020112012202021012202222220022220010012012120011221122001220001120112100220221112222210200000021212114-
401010212002222200100020200121120220210101011121101100002120111000000100122022121120102202211022111211111112012021001221112201002222121110102022201024-
410202220000212111021010221102111001110100112211200202221222202120101120210112010221211100120222002102200011201010111020222212202212111112021200000024-
411001101102121011200220211102110012102202010212121000000122222020111101100001102020011211110012100020102121011111111111012122212201201102202002022204-
421222012010100111101101000010020112021200012201001200001022110102200211122000212220121101221120211212102120012100111211011001111202020202000020101014-
402020111200201101112121120112211210202010102021100020011120212022222010012002102000210221111101122122211222011112110202122111102002120201011002000104-
401200102220102220001202021122210000221101212222221101021120200212112012210201110220020012210101210000111012111010010001102220022120021101111111210114-
411211211201200211021001220111200011210020011010110112022121222211122122002222120012220102102210102210220021100122212102022112211120022201221122102114-
410001102211012202112221102002010001122110112111212201100021111202121120222201112000100022210112222000102200121212022221122211101122121021110110200214-
421222221200221201202221101121022102021100210211201222212201212121112000120012201100122011012210110010000202122200112121102012120002110001120121212214-
412120120011021010202121210202202122001121112210122220101012022111221100200110100011101111201201212122012210221121001012120011020212202001212222011204-
410122001212111012012101010111021010212020101102022222202020112201002200100020112100000122100110121022200102122001121120120012210000020120102122020024-
422000002200222001202012002211020110120220112220012120211002112101111120002100020200112011111112011102110212110212212210122101020022020021210010112224-
401122010022221100021210202111210000002121020211211000011110012221202111010110011001202212010010102111100002020012210100010121101120100021111202002214-
412112100012022212022212010211210102102121121221012002211010201200211222102020200120012002112201202121102102022021002011012111010222102121111010211014-
400222222111101011211102220121120212221121211020000111011112210020121121022120112101102211200200111122201200120012001020001012000121111000100100101124-
420102020111112201220020122100021100121202111220111212011010220001022020012020002010200022020100112120012201100221101010020020022002200211020210012014-
420200220022220212011210100100022012111211021122000222110102020001210210101121120212022112202000121020222121112222112201011101200111210222121002200204-
401201220011101221000210221111120110020112001122221101111200120202002122002112022210211102122210012211100001012121000120211111001110210221012022211224-
412020022021010111112001012002011020202120111112210121020112220120201111002102220121011110221111220200201112220100222211221012110012201022122212021024-
444444444444444444444444444444444444444444444444444444444444444444444444444444444444444444444444444444444444444444444444444444444444444444444444444444-
