444444444444444444444444444444444444444444444444444444444444444444444444444444444444444444444444444444444444444444444444444444444444444444444444444444-
421210010200011222001120220111002202220002000102120220022122010022012222212112222102110212000002221000202222110012120201000000111211220211000102022024-
410000200211001222201102200200201210221122201210212112212212011101110002021210202110111212200211112210222221020211121212101012210111001210012111100114-
412001021022212012112212200002102212001011020021020002110202210101222012210110200112220221101222201102210120001220112011222000000110100002020222010024-
400201001001021011200121011020112020101010002022010110120221010120111010012200001220002010210002101102202111211112012011120001200221200211212012021204-
411002020222201102120022212002201102212010000202121002020222222000111002111002122221120111000202002001201111202110220102000202120000002010200120202004-
422212002221001221210110122020201202201111020002221120000012101220102111010012022122010212212020200010221122212210210210221002100101122010000020110004-
400012000012022101120202102221210120200102102121110201001101012010101021221121110101100122111011011211100210212010221221202202100112100211102001102104-
422112202102201020021210020021022020000211121021021022110200220212010011111110102200200022220110120010220110212222010220212012011000222112102211220224-
400220222002211001110020122221221102121122210021001220101022011001210100200012020002212222200222112222000111021012011100202222201201220221110101122024-
401112002012112222201221221001012202222200010210002000112212022122222110210020000112002102010100112010212221011110201102220110021011120112022021101124-
411102022201211021121222021212210111002101200202000202021021101222220112220101011001212101210100011002021202010222111001002220102222021221120012220014-
402200002010100222011002211202120020012211212000221212211201001012101202102011202012101022000222102002111220212021002101020002121020002110021120002024-
411110102201011222002010020100000011112211022002221010212211200120002202221201201210121012111000100222121002210001101101100020020111120101102102210024-
402000022010122102220002110021210220022101010011102010201011111111012021110221120220000001102210101010122021102111011100111100202001122121112111201024-
410112122210020011020200022221202012122120021221220111122020011200121222012112101200001002100112101202212212020210002221211202011012202222121120020024-
412100211101121002200222020020002022010202211011111002002120122121220121002002022002010002211100201100122100222211001121012111122222022121211212121124-
422200210021220102202212100210122202010021112211002220011020011100001101022010100110020022202100102111222210011001100122011201122122100112010222121004-
412102012210222100200201000221010221220211110221100200011202020112200122201101212210020121120101220100211112022202022121022020220100010200200101001124-
421012120220201010202210102001120001110220100120122012011220002211102110102111222121112212001110102000012211011122111220101211222221020020201210020224-
401010212202002010200202021210000201000200212012021011210212012110201221021110210202111111002112102101020020002022002000010120001121002002020020001104-
400021211211110002121110111120020120201120000022020211202201210200100001102011000011100001002011111012202010010210002211122122212111220121122110202214-
420022221012101020200222001022121100021001202200221102221011001212121002202212000222020211121021201222201020222120112221122001111211200221100002201224-
412200202001101202102201121211100222001220001022000222222020222120202120102200111222010100201212120110111110122002221102001202120221200010211212210004-
401102120112010121020220111212021012102120110202212010202121001011122100200010110210110021101201120220200011212211122210012110102011000022011221012014-
402002110201010012120202122210102211210202110100020000211021012112201110110021120110111002012200102010211222121211110102021120002001100022000101111224-
411221212212210021010022002211122212101212221121221122122010100121110110222102122012111121212200220002012221000122222110010022022121022101211002010114-
412020202220210221011202101000200112000102022200011220112100102200100112002111010121002011121200011212102101201011102211102210220201101212111022000024-
412221222210211122112102110021211102202212021012010211110210221001220211121121200011002010022000210100122020022211100102222210121121001102010211010224-
422102211210122221122121122212012102101110112111120101211002112210210120201220001112211022010122120000010022211121021202112222222012210212010022110124-
412120000200120002022020022100010200021200110002101101110012010011221122201011101002021011121010102120202222022221221012200222020020121022201202021114-
400101100201220000110121011102222221110110022120000110211122022100012020202110100101011222221111021012101122211221102001101122200212200102100112222114-
402020211000012112221222001212211101020202002112110222110012221011011120000221202212021120210010021222000101101222211011111020222221011201100111011114-
401012001021022122112001101112200000202200222210122200202101201020022212021021012121210111202022012220101102002001121021201220111200110102102002101024-
411112220022120102222020100110122110122220202212201020000100001122202201202111222200100112220122012211111220120212022112100012110121011011100100020124-
412000122021220102220010201010122010022222110002122202202102101020020110011010102011211012111110101020222212202212211112202001110200102122022110101104-
421010200121020002020110202010220002200021121001112010100012122022101221021010220221220112111101002200112200201210021111122112001211100122122011012224-
401002120211222122221112010101002000111201022221020111200002121021001220212100212222101221201202120101012000002121100220202222101111022220020111110114-
402122201001220110010120112021102210011021212120100201111101211122202000202122111211102101010002112122000222122210200021002110012101001001000211201214-
412000211200110102111112010021200212020222001011012012121012010101211120200122220121120022210212101202012111210021210111210122120220211111200000020214-
411120222012221110212112002100011202000222110122001221000211001012112100021000111222020012021022011112000120120222002021001201201212201122102222122014-
410112112222222112122122200201120110221202011002200002011122222212210121010010000000210120020000010001100211121120222221002221101210010101210020001124-
401000002211000221220112020011102000012122112222010122222200200021211110100220221102012002012212122020111211111100012111021021022012111202210011021224-
421122212212122202110200100202122221002211222220100212020112211112001020021112011110011120212020022220000002022012201010000122012022020210000220110214-
411122100210021210112021210202210222201201200022212101202221222220022021001011120022111011111202121110202212102022011210111111010210011102001002121114-
411221120212110211211122110000112020102200221122021121122110222222022222112000112120201100220111200010110222112001211110001012210001222021012101020004-
410210111220000011000012100111212210012221022001122111011202010100020220111112022022010201220221002120210022212010001200112122201102111011002101122204-
402020202002202120110201220201001101020020002111212100010121201001111002000122110111120100110201212010010222222100220211110222221021211100021221220224-
411202222002120101101002220220211200210020120022002201201002021112112010001102010021020201002100102011122022121100201012221020222100200220000020220224-
444444444444444444444444444444444444444444444444444444444444444444444444444444444444444444444444444444444444444444444444444444444444444444444444444444-
