444444444444444444444444444444444444444444444444444444444444444444444444444444444444444444444444444444444444444444444444444444444444444444444444444444-
422200120222022102010001200201002200110020200210011112211010100210222102222221011210000112222022211102201200210200121201122121201000011102121222021124-
422111111200121121021200001000202120022012220202010021000121000120121101120102000121112010100211221202020222000212001010000212011100221010011210200204-
410020222021021220001102222012211112121201212211122000001100222112021020202012012122221222002121010220201020000010211112211222110111010220201210102124-
412110210120111100020110210022112200211012111120000200201110000220220002212212221200201112122001100200000020210012011102021001011112202010101211220124-
412022002102202101020020112201202021112120220210221102120212020200022200222211222001122202101010021012211000001210202110020100121210121100120201201204-
421112122002112020200120220202001020020111221022122001020012222110220202001220111120112200120110001021201222120212200100102210010100010022112211102114-
412210222201222002122011112200210022111012220212112222122121202201122200110021012212202211121202001121021220010010102120222200122201221221211000200204-
422002021200011112102221120110122100002202011220111122221210202110111112021212102002110112111011221102222201121220202001000221110010202101210202000104-
410112202100222000000101100220211010202201011121001201112011202200210020020022100110020102121020120002221022122102020011201001112201021122122112122014-
420201221001200010012200000001220022022201200001200011101012120002002202021002010210011200220111211112002002000201111022201011111011022001210211021124-
420000022021011211022020220021111221102010111010202000112220110011200110102020011220022020100211101212020020112122201001021220210221011102202102121214-
401100012101211211200000200122200211122021200102112122101100211012020112022022112220121102012110110211000001202021010210212201120100000122200112220224-
421210022212002001101121000011111120222022010222111200011211000012110211022101201010221201201002000000011121210222211022022200120112122201102122122204-
411102110101210101112012101100112001021112110020212102110201221101102222010122120200111211110101001101011211010022222010220210112011222000010101202104-
420210122100100212021121120010011222010012110120121110222120002201222110202002111111222022122022220221102020121201102011111221220212101012210020101214-
420022121201210011211202002110020120101010011111020010002101021011011202102210111211112211121220121000112201001201100101102022120001222011110012111224-
410121111122222122010202022221022102221102201021021122122201100111210220021120012100122112001100010200020002201020000111102211001002011212212122022004-
400011022021212211111020122120002212101122011211100122000010111020222011221021022220122212010001210200100110212110121001001102000012001002120012011224-
400110021212201120020110200102000120122222010201002001212111202202000002201220202112101100122001120210012102020221222221120211102012200200002102122214-
401112102110111212101112202110021102102020110011202020220022221212222102200120200211202200100202202001011222010112000211121110212211012121212202121114-
421112010220120101220202211211100220020210100110011102101110001200210210001012012110220010002210001001012211122101210002211022121102002120121001202114-
420101121221112121210201220210000100120211100121201110121020120012220020110212221022011010100100201002200000111222022012221211002210000112221212111214-
420001102021101220211021212022020210001222111020211120222100101000021021021222100121201000022210212210121011012222111122121210012110010222110220201204-
422220112012010202211200010110002221011212221200110121212001210002020120202021112012000111002022010122110201002220010211111112012102012012010120012214-
421102201111210112202211212200202212221122120121212212000011001110111210221111210122002002212121100112222001120021001102100020021200111220000121201114-
421201212202122210201022022102012211220010221222200022111110020110200200221122011010201100210120112122111211001220020202220011111120121111022112112014-
410212111021111220022102222001021212220021102122202221111012120000021222011020011021002020112111221200022101212110111210220020121120020000211000002004-
421011110222012000112000210101120201112210120102210202222221201221012120002120211220121211120110202111012120222100122200221212122211112202022002112014-
412210122200212110202020222020211222221002201122021211001111210021220220211110212110002221202110002012120200121221200100222200202221022222200211110204-
412122010102222221102000011010120020011210112221100120012211222221111111121021000210110001200122222010101000011120201012110000102120002020011102111224-
410222111122001210001212111111010110102222222122012100002102101102022212011112202122212000200011111002112000020012211020202212000122001011220101002214-
412002220002012111200101000002000012111112121211222211000011102102222010211121120011222000021122212110220120102102011012010122120001221002021211020214-
421022000120222120002112222100221111112220112011212220101112001022111000020120022021012000220012101111020100102120122202202000002001022010000120221014-
421221121010201221122002010100120112002201221122102201212121010201212020122210002221202222210011201221201211020222211222110210020011211211111110100014-
410002211110021201220100122011222120000202020002002100211212200222012202012200102200220101112012112222222100100100010121001112122102011200020011211014-
411020011001001220211200211001000101021001010201101221012100222111221120200120201220210221000201202122012102211102011112010110011121210122220201112114-
420002202010211022221002111012200112122021111100112020201221020122212110110201020020202021200021211210020110001122111221100212212010221210101121001224-
401221201201121022120211101012100010221201000011012110102202012221122120101200011000220220000211121120210122000012100021111101120202210222010002201104-
410220202022202221102121210021211011012112210220201212012221022102111220121101000101111112021212102210002020221211210210121121001020122120001111000114-
410121022101002011022202012200010102012220100122122000121212122010101112122020002201101210122102110211112112221211122122221111111121002121020101001014-
401122210120210001122011220200020010020200002101000102100010200220002010221122200210012100012011001020011100210100200021001201100120112222001111011114-
420112022111021002211022011102102111110212002121120111210120210012212210022121010101001101102221220122202000210110110110002111212221000220000011000224-
401002212202201101210112010202010220122101000012222221122110111101000210002001122022000201022022222000020202002201220212122211222010000101221001211124-
421122102220210020202222211111002222002211101022001002110201222011101001202102200221112210100220120002200011111120101011011211021120210111021201020124-
402022010200110200212110000002222100121221220112201222012121020211220120220222202211111021112111111000012011011222211201020201100220200002122000211104-
412020221022210201120002000000211121102010002212112100200211211012020201212010112222001221111001120122020020200100010210202120211201020112201100000104-
400121120112111211222101011101022011102112120010001211001011220000221211002101011011220121202120112011112212020112001020120221012221022010020110200104-
410122210121100021121110011110111211201002200002112220120121121022021200101111221002020220021200220220210022211010001002100200100010122201020000120114-
444444444444444444444444444444444444444444444444444444444444444444444444444444444444444444444444444444444444444444444444444444444444444444444444444444-
