444444444444444444444444444444444444444444444444444444444444444444444444444444444444444444444444444444444444444444444444444444444444444444444444444444-
401110201010221120210101120110100101100221121211202120111110010020012011122221012201122221112211112221101202121201201102011110000102111011022000002124-
400212011202220100211101200010211101221201001111221102222001020011112201202101212011100010012211010210222200102120122111201122002012101102002220100004-
400222020000122010001011202211210210221021120220212020111212000221010112000022211202102100212201021221010100122012200010201111211100122021202210002114-
420022110222220211021012100110211110120021110002020001012122000020222102022110200022000011212002222102022100212221201002212211111222222021111122220214-
412110102002000120201002021011012011212011212112010020002200221212001021210201011121102210021110000002222202112010000120002201201001100211221021121114-
411120222121122100120101221001101212000211120020022112121220122122111221000001001021111200001212211000210101112201112120022002020221220201120001111014-
412121122211022000120111012001011202022121010100202121212021211021221001111121121102222112102120011121121210100000021211211011112012022110110100011204-
410212221101100011112010002010202000022111022022111202220012020100112002000021210100110002021021122020102021100022021021212021002011022102222200021204-
412220212222211110020010212100120201120012202212202000212100221121000101212000202211101011102021200201010100022110020222100101001020110102022012110124-
420111002201201000010011012110100222221121011210210101200100210220120210011110101211202011011112211101200102102000120021020101120010022101002110102004-
422210001111121212102122000000101222112202022021111111002022000021021011100110011200210111122021021021121000000221112110120001012211002020201010211024-
410101111101020112011212101201122001210012101201220021001221211222202110202221010021211002112001012221001012212011002111202120111220020011200200010014-
400010020110011011220220112120102002220110212021122000220102220122020202021102111100010012002121000210221000201201022221222222211012010020000101212104-
401210002222020120021121200211101201000112212022111221210001101220102120101020000102022011120010221222011010202010110121020122011121100222112121112024-
420022122110012212202001120000112121012120000011010011021210122101212101212001202002102200010111011011002221222021110121122111220122212010121000110204-
420021210202120001201211122221222222202002002121100212111210221001122202211222212221120021210101210211222220011201000121120111211010110111112020111024-
411112210200000201010202200111212021122202022001221202120001001112122012110012021112020210112212110112111101101211100220100012021211212002010111021024-
411102021112102211101110020111122002210002110010220202210212120211100102011020112122010220100011010112100021101222122020100110111011102021022021210004-
410210120012022211001221021221010220200211022221000110101221201201112120212022020220020021010222111222100221110011202221001200000022220200111210220004-
402112122012101012211101101122110221100101012000211221121202201222002222002000220212021010000211100222122110111220111112211120101112220220220012211024-
400022020111112222021010011020002022120210002212100102222221020112020220202020221210120100100210122011112110100120101202102001021221112100110121020024-
411120020212000100002002110101001001122000211221102120211012122002210100010212010220202210120222200221201121100001121221200222001001000212111210020224-
420101222001200212022200211010220212112220201200211112012201121102012101101012000112102201222100011002120121011202220122101110201022210112100012012224-
400122220210011221001110202111120110221110101221012200202101011021102022011012011201220021012011000101110101201120111001111202012110120111222022112004-
401120022200010121210221101212211212200212120202000212210000020222010002121221222202220000221222100022011220220210010201220010001120011210102221100124-
402111010001022000200021212221000111012122022001100111222220110102100202021210100001002221120210222000222210200021001220212120220122021120022012202224-
420012211122002002022002100121001020211221122010111102200221112020001121111012010121202120221121101110021200020011222001210212210210201112001221021104-
421000010020202010200111100122202210020122121202200211121202202111121002101102122012010122002211011011111120212120211001020101222202212011221112210024-
420012220101002222221221112202001020200020211021012022211210210112211022120011210211102201020000001210112110002011212122012200102111221122100122120214-
421001212122222112211202002200220002201010111112121221110021221020222221022120211121010211010110222222110102000202102120210202000011220202112222121104-
422112222012201100112202202220021112001011010022002100100210012112102211101121110000002010221211002021000221201210011010110022011122211200002210022224-
420021210121201001110221002101000001202101122122020012220002011002100221010121210021221010100212221220121111221012110210000202122001122002001211202114-
410100122011001222120021200121202021210122210111122122220011002211100211020110221120210122110011011112111222122002210000021221100012110110202202002204-
410112200111211022212020010120001001212101120212121121012112120220211210220112211220102012002011212110022110221121102102122120121120102010100211112004-
402121011000211002112011122101200110122222020021000211120010210000201001121222120222111211111110201002101010021222210221100022201210101120010002102014-
410010020120201212112221101211101200010001001000002012100012100212222100222112111100200120011010110021101020200002020002211012222111101201011010011014-
401220122020020210111112202221200012000220012210110112001000010221102101221122122200220212020022000200122022011222000221111020112121110022222010020104-
420222001221212121122011110102020102122111002100012202021010102021102100021102220100000110102202121000221100010001010120112020021011210202222000211214-
410102111000021110112010222100202222211022110012010001021201220020220200211102122020201121202212211120201022220010001220002101011100201202111102101114-
400210200020011212121100211102000000010101010002100021211110010021111122101121100021100101112222102112002000000201102200001011120202100012000220222214-
401222001121212200100212010211120221011121101200110110110001220211200220011202111012011112221221002200022001222022021120020211221120202220122212222114-
400210101020202022022102221211011020110022200101211111100100221200022121201112022010111122222021222001221120012101202112200121200112111012101112001124-
401021200201222201121122022211210100220120102001200110001202221101202111112120011011200011000201022010011000221002200221001120222020112101201020020224-
401110120022200211202120100101021201101121100121020100212112110100021211111100010012201111100022221212011200100222100012221002211111112120020121020004-
412102121210222022220122022102221112121010120210200220121122220011201000121222202122100120021010022122002110221212112021220102002202021022012001100024-
410010021210001202010020000110212122112222112112201020011021212110110211201212000120020211210222000102221200001102111212021102000101220202210112101214-
420000200210202201212212120020020001102220002011122210010122021222010220000020222201000111220002112200000112002022000012122211122002212222111120110204-
410220022020222112202222100012210121002011021021120201220212210111220000010020201111220220121120200000222121021121220111221212122122100011121012011004-
444444444444444444444444444444444444444444444444444444444444444444444444444444444444444444444444444444444444444444444444444444444444444444444444444444-
