444444444444444444444444444444444444444444444444444444444444444444444444444444444444444444444444444444444444444444444444444444444444444444444444444444-
421001112110021220120201021212022221020121122111102000220110022112002201210110112211212220120022112020122122121022121011201211201212200202122101120004-
412212220120200202110110222120001002211021202112210000201221122101210211021111120120012221002121020222212202122012112001012120020212002201112111211024-
401122022122101020010021001100121122210211110210221221201212101111110221012001200122110122110201022220122221201001002212220212000120111222112212122014-
420010221000000122012010212200120200021011101022112122112020012120202212000000111122001020202202221221020022121120101001102112220210201021100200001014-
401221021022120010201202102111021011122210200111100110020020221100122011222022022122100000122002111121020211112220210211122110020021010101120222222004-
401221021221022111221100021001022000021100022002000220020122220221021012211102122102122210222000001022121220000212202200011022020010221200201221112004-
400100021210022012010101102201221122201210200121021112012201011001100200220110100001220102002212122211212120010210101111202022100122012220000201202224-
422212121022220121211012202220121212111122022002011121021112210021222210102121000112110112120002201122111020202012122202220210211102012022001102111124-
411101002020010221121120121110020121000011112102111202100212000200111212110112200222201101202121022010102011111120202220100222101000111100020001200004-
412120210222201022212020121121202110100221001011010212102022201121120022212210100120021110212022110212002010002102200222222101200221001112102202121224-
402022202021012110221020222012010002211210011222122022101021222010011210222112011112020021211120101022110111001110021021101112010200211001212100110204-
420211211202010202002102220112022210201112002201010200111011110222120120202200212010210011112200020010200100020011100101202012220021122222101110222224-
412120102221212001120100101111020111111202101022010110001111000202201000220000220010201222212010221220121222112000000201210011002021120212020121222114-
411011010210121211120002201210121200011102221012022120111010000101001110222111221101200022210220020222110222120221122110112001201201221211101022021104-
412222000120110201220110221022000012011012021121021002220011102021122120112011010111201120020020210002022212022202100111110000221010220202002102021124-
402111100102201021001010202111020021011102221000200121220101011022202200001111211200112121220211200000221120002212201011220000011210011002002012022114-
420020220112022110220121100220000000022101101020012200120201022122202111120222200212210022122102221110110111102212111111120222211100202211002222220104-
401001001022100100021210011101012220201211200102022020200210200002212110200002122100010120010002102212012021210001120002210210212202102112121112020224-
422012011121210111101111200002211111220210120202102112110220021102211021201020122101212121121221101002201022221220102212121221000102002220212202102204-
420212100000002022201110112012001120212022110020211112011002120100212221120001211111101010000020101102222102121211002202210022200211122101001110022114-
410201020220102101122010011111121222102001002002000222022201112210120122002020102012001121220010110220121021022110211201102100012212222110002000201104-
401021010221202120100020222101101100212122211011022221120220202210000101220222121001011210001211012111220200011011020220100102020010221112210210111104-
401121222221102021120122122112100011201112200121111121201100012010202101020122110111120221110201122000020001102122101212010122001001000112100121101014-
421001220220121101112021120011221201221012022010120122011211222001220102120211212210001211012210222212200012001001002020021101212100211210002211121124-
401222122020022221201020122122112202120020001111022002110221202122220002001211211022112020022201021202222201222210210102111201221122202110001111210024-
410102201101121201200102200002120012221120001001012201012120222002012011122101022002222001001100101211102210221212110002020000101200111220011022102104-
422211110121002011120112201001112010102211012221012022102001222102110200100110202222111201111021201222001020120111020222001021210000000201201222022224-
410001212011220000012201200102000012000201001110022221210122101101210012011210210211200112021120110120102221122220100210002221011122020000212222122004-
411120210201101111101222122212222022111200201211222012011202220210102022211112222022102000102010200100211010200112122022022202201202000120220122200124-
402212210200002101201202022112102012210021102222121100002120202201012201110001202222020021201100210100220002202202210020212002202210222021111202201104-
400211112112202212201110221111220221222100111221002002200002211120122010101101121111022100011001002112202210002222220001111000111212022220212102110214-
402002022102022020220020122222000120210121010121120110001211100020222110112100210000222110010000202111000222211212011102201100021120011202221201112014-
420201002212202020211211010111100210022011212000221100112101101221221200212120200120022222110202111212010202200111110121202011121010212112210212001024-
410220110002020201222002102221222111111012200121011211112011222022010102022211100121102202011222202001000202100100002020022210121001022020220111020014-
400212210021022201010101001210120210211000202010211122102100111001100211200221120021101121100212102011012210002202211011121210101112121110212010212204-
422011221111011021110011201202110201220102220011020210020121122210202212101222121221100102112012210012212110201110211200110202011002000201022012212104-
410010002201220020102111211100100120000002200212112202221221222021121220112000100212010021111211001111210120210000200020100202111210121101101221122124-
400020210212120012200220000010022011110001100001111201012211220001101222110012012122111022210112020021000011200201221011122220101110021210212212000004-
422120200122221022210222120011000022101112121112101122102002120110022002102100000021002222110101021100020011210111112012022200022220102122102112212224-
422202112012212222122002211022011122220122212221100210202011110112212102201000102110201200102010100012001220122211212222100120002001102200222022102014-
411202120200112110022110202201222022010220022202122210010200120000210021010020110220210120202012211210011001022202100001002111101120021200100102220114-
400012211211111021220221110112120022122111121101211222110111212022120112200001101210000010200022201010011112002001211210111112012111220212110220220214-
400202010211220221122200101011211222001210120222011201121020221112202220212210022210010022200022112112100221110011210000122120121100110010111212221214-
410212222222012112102002120211111200200201110001020112010221122021101202222011020001020202200200212212121020222101221101101122220011122222110220021214-
422221001212111022221210211112102002122010010010002210212200021121012210222021110000020000110102221100122010020221010000101000101000102110210002221004-
422001200122201020110010102221221220122021210111222002222211210002102020111012220012100200220111112020202000001100120022120202020001002111021101102014-
411111021101120220022122012121221021000102112110012120102211202220201221200022202101100021120100201212222121201222201021111120220102111011222111222124-
402121222110021210001011121001000200111212111011120211120001112011000121021202122222022200211220100022101220120111101211211101001120202011220000202004-
444444444444444444444444444444444444444444444444444444444444444444444444444444444444444444444444444444444444444444444444444444444444444444444444444444-
