444444444444444444444444444444444444444444444444444444444444444444444444444444444444444444444444444444444444444444444444444444444444444444444444444444-
402222012111021200100100222120221011112201012001120121002101221020022101112011201201220220220122120000121221212212210222012012122211001001120110201024-
400212210110222202120221212211101202202220202101010222220222001201220121022201022100121010101101101202120221201111020112111011102101011211122110020114-
402212121012221001112000200220210112211111120121020121221201122022120020112222112020220211011012101021200112012100000021012101222022101100001201021204-
412122002202222202021001101122120000202202220002212001111100212011210212121212000001111100011212222102001100111011112200012012102112021212211020212024-
402111111010121200220002100221212012001220210110021101120112121012000010221100000022101100212022222100112201012110112122211222220112011211001202111214-
420221222120110102100001010111010022212101122210121002220221022111201221001212121222101102112222022222200100200110220100001202211210120212010100001124-
420101002021201211001011120221221222221001102221220010120012221222122011002222012122010122101200011210022100222110212220200001022201010022111112121104-
412012211222220102010001220201211112021210021100012011201211202120100020022021202000210121021001222222022112220020110121021002121201112020101110100124-
400120202021010120021211202121112100211110022000102020012010100110002121001110201111022002012022201020102211110210012220222102002102001001211021022024-
412012222202112020012221120021022012211022102221120120202202001101010120101002221000222101010010001211200100121002222020212001011110011220101022202104-
412000112220002002000210202122111211110221220212011111222222000100210001012020100012111001121100111012020100202012002010020101001120201102121122120224-
420002221201000012122102111101102001011120111211012011200000211011100002222122211112201212110011220220101111111110000202112202220210002101011111010024-
422221220001100020102101000112012101011212200110001201202102001202201211020210012020112221010100011100122220100020101221122211111020120102212111201004-
422012212122122101121010211002112100221002022002121112222021121010202001101020010222011202011001220122021222100020110001212210112201100011111101121214-
422112122221212000221000202011001011222011020200012220021120112010100002200111122212020121202011122022010221102202100212120020102202112011002220100024-
412020200212220022201212222210100201102220101202220020111200200210210000010122020201020110000111001202202012202011211111102111001112112121202100222124-
402020202222110211001010221002121211022122202220201220100020122010111212011211200212002000202220020120100102000122201002022001101110012012121020101214-
421022211100200102222100100020111100220110111122122120210222001012000201212122102002210100122111221222122212011101101110211110011101110100002002102204-
412002211210212202112220120000211110220101202022122211122212200011102122211000120102210110202022120221112011121221102120000002002010102000222121212114-
411201221102100101112202202010012211121001102021021011221000102222222221100112201220111210010102211020002001220121122111010102210110111112010101101004-
422111011001102111022001101220220021100102112211121120101202110112110100022000220020010121011001001101010211222002122001012112011222121122221222120124-
412020011021000211001000100210202020001022200120010120200022221112222122102222020120000202010100011102222222001120120221200202011100120101100111001024-
422101122010200021122020002002010112010101111010120101021022001010100021012102001212221221102122222221222210002210022121001020202202200110211210212224-
402012211000212200220122021210102202102221221020201201102212112002100102202101200120011102020202001112001010220102111220212210200220201101210210120024-
411022220212101101210100110010000010002112221012010120220020102120202011200011121021022201112221021010012101002122110211022002020122200212221022002014-
412012100001010111102011001202020120012002101221220221012000210200012211220211011111120020101010120211010102120201000101001101221112021120122210111014-
422202002101101122221100000210102102110110122022100010112120020120020002012222102010100211011120012202220101202212010010022021201220022202121121111024-
402101102201010002201102001020111110101012010200112011122102001211100210222111010011222202101012120121001011111220210110121010212110100012110201110114-
412011001000010012100012020001112002100011202021022020120000110121012112220111100011101221200021212121011201001221021101011020021200200110022221100024-
410210010202122201201221222122110211020011011221100112100001122220121200121002011002122111222222201112112210010001012210200020102110020000220110002114-
411201211212221110002022200210001200111001002001100020022120212022102121000211000021022120100100100002202022110212000212121020122121100202101002102224-
401101222220120110111120202012001122112022101001022122000220211100001111102201220011102221100220211222022022001211112021111110100110001221100222000114-
412121202112110220101112202210220222020200021022120100221112000011222002020211121210000120002000100122010221200101022021210021111121212212220011011224-
421100111001222211110121111112221102111221112220212212200022201021222101012000100201000120002022002001222122220122022101002112121111121011120121111204-
402111202221210200202220020212122001201120020212110212111101111000112111121222210010222122220122201021110001102102211101010210102222221122010122022204-
411002202021200121001021100110010010121021200200222221001011101202212102112221202010012011121202211010200011202200012222000102202121021222120110211014-
421102020001221112110101102012011010101101121000202122101122000122102211002021210102012022002222011020220212112001221011002000210121102100101210202004-
412021022102002002212102201201110221200202111111121210120120022211210110001201102211010210011222201020021202101212120111021000000111021001110200112024-
410020020010100101220200121000120200111211201021201101121020202221011202012010221222020100221022020122002022221111112112202000102022210200201220002004-
402210220102112111200100110101201022202111121201111022011001220112112220110012021100222021111020211100010202122022010202202201112222021112122202211204-
420212202100111002122012212020101122112022222211012222011011222202210221100202122002222211111222101010000120210102121020211101110212200202222102120114-
420122222112020211202000020111102001010201010200111112200001001201120121012121021200022112120112110000020221012021220212222112120112002010012222020104-
401102110120112110121001011220210112120221000200102011101222200111121120122222122111122000102221110012022102221000101201002022021222220222002212122124-
412120101120121001122022022202120221020102000011201000221201212101022020210011221020010212211012220202222212021102220112010001011202112221121000001124-
402012010110210010111102210120110112001012100220101200122211120212111210100110212112201022000210222212102011021220210001110212211222001112221221220124-
412011201121212111221211000111112020220202222211011002122222021211021212211001202110000202102020201220001021111202202112220100201222221101001111012104-
400202022202000200220220021000001000222210000002012111112122110210210002012121111220101021010011022021110122121211111101201000210100122101200011021124-
420101010212020102220200210011010022012211101220110220002001112121100110101012212201011001210020120212022212102210122210022221000122200110022212220024-
444444444444444444444444444444444444444444444444444444444444444444444444444444444444444444444444444444444444444444444444444444444444444444444444444444-
