444444444444444444444444444444444444444444444444444444444444444444444444444444444444444444444444444444444444444444444444444444444444444444444444444444-
422211012020201110102010101010120120110021012112100210110202000211102020112100120002012011221022021201110022221220212121012021221201220222010101202224-
402120021100012111112212101111120002020102111112022000220002211111210102210001000002222211011220122210212010020112210200021022112111002121222201221104-
412022002221220001222121110021002111201221010212000112121202211010201202000122222011100210212220101202000212210002120210110000100020022210010020022214-
401010220112201211110122222001012021202001112010212021000201011112010110002002120122121000022221110200200001110111110201010202210211110010101220000114-
412210001120110101101012111220020200212000100200112111202200102022211221020000001220002101220111211201011200000022100200121100022122201220202202210024-
401101111220021200021122022000101122110102202020110221222101000010020012102220000211110020212002102200022020010010200020222202022221021201211020112114-
410012100211020110211212112010212210211110110201210222022000221002220121102021210212011212201002022220010201001012221200110121120121120210211112012224-
400000111220112021020002112002011211212222110001112212222112120001020021222212210011002010121220200112201001211011121110222101200100101210222021201014-
412020020202110010022222010011010222110022010102110112000010120100010222102201012210112000201020220002122021121202100001010000222211102202010112002004-
421222200002011112100111110022220221122111110100120220021120020120102201212100122000002202010002101212022101201200020002112000101011110120200200100124-
402121121101111222020212121220020121122121202002210220111021101121011101100021201020020202102110011211021002122211000101210211022002211200200102222014-
420000101101111212021110001210021121222102010102121020002111202000120022211121221210022002000101100020000112002102212002001210210000221011100221002204-
412212012111100211111000100021001022102000200200002211012121222120212222101122200001101012201111000100010001012101221011220100021020200202100002112114-
401022101112102022212011110202100112112000200200001020020210012100120102011210222020021212021001011112200101011001001111121202202200201112001000102124-
420020122201112111200200122100022102220122211101202120212101202200201210222202121022211222022112202201001212211002221121012000210011112022012211220114-
401002211110200011021021000021002010011201002122101011012110211100101112020121101110002010120010220000112110012222011120102021202200001010212221200124-
400111102002200002200002121021101101122002022101100011200200220110022210100100210220211110220001211220210121201110011012221211022122100021212101112214-
412122022211012012110121012120101110211122202002002021002012111122000002210101222102110210010212112100010221200202000211111202121101112101220021010114-
421220202010110102212010121212112120022222200100112101220202010101102000201200211222110111221222202221210211100000111120101202201010101211220222100104-
420002020110101102012011200000200011012120112200012010112100010110020221120022101000001122222021101221222022111200011022211220200210020200000112200124-
421200201211200222201112221212121101112110020202021000200021021121121222002122012101120011002120011010212110120010110100022022011201102001012200000104-
400101112100221121000120212121122222001200200011220010122010222221000011221111210221001122210202120100112021210200011011020002000012121100222011121114-
412222202201210210211220210021112010200012110001120120110221122020001211202102200022000002200221220010101100111100212000021001211211112110212210211104-
422201212220012212120100221102211101210210201121020111212221022002010201120120210100202201022000012212010020210210111221212111022012112220221111112024-
411000022212021010011001012112201012020122022110021000022021202211002020222120210201201211111221111211112000200101002101111100122211202022100201112124-
420122020200012112022201022010111100122122020000010102212012011221222112011122210110212001000002002212001221010001220010112200200111221212211200222214-
410112111001200210102001002000111122221202002201110002011020211212102212022112220221210011112212112220002112210211112022210202120110120010002112222204-
400200122020010001220211210001112020120001011110110200121122211112222122021101021110211001121010102200120020222001100101101212000222100021020102001224-
402020102102202110212122002002101220201110122101010220020211112110222201100221210000101102110100222010220002110112222112111111201112022101001001120214-
402012002202022221201122110221120212102021000210122112000221012102002221100020210110210022100121220100020112120120200122001002020220121021012022000114-
412101210122001011222022111012021102022021002222120010012112202122010120001200021012021001010220200121001010221212222000110021000200111000122110022114-
420100021122202111021122112000000221111022111112110220220222112021121112100000010010212022102011111002012011200012012021221121112201121021001000120004-
410202022020000120210011201121201011100020000221211220112002221012202111201121011002012110110102010002100111110111020210121200211012220002202122022004-
400100110121210011200110211201200110001000211011101011021202120001220211121110002011211121201210022201012112112002020020220001100101120212121001222004-
401212100100211011101212220100021202121212012020112020100222211210120102000101012022001002111120122121222121201022001211221010121102100221110100111014-
400211110021110011200002220210122002212010112102121022020002012022220000222200001200001221200200110001100021211020211022120100202112120220100201022124-
402122121002210012111022111111100200120010201021100021000102211011201100222121011021222221212112011012022012111102000122011021110000222002001120011204-
420200120211222121111020112121101001110010002012000002112112102002001011101101020120202112020101210102020200211202120100020101120001222110011100120124-
402021110001022211010222012112200212021122102222212122101212110211021112100221012121210122011122101212210200220211010222120202222022111102000021110224-
412220200202022202111210012022222202101021000200111000200212200212001000020211022001122202201112121021021010102110201121211122212220222000220212010124-
420102212002101211012011000122001120100101102221222012020222011001102001022201200022210101011000120121110112221021002102220122212202001202111111202114-
421100110000110011221011101102021022020121222211111021220102211221122202202210002011022000222000222110022001102020202010002020000000022011102011202224-
412212210011100202001002012000200101212010212102001022102022010020210122002112122202102000221202010002122120220211221121122100110102212100222101211124-
402211011022100110111100122122222001020212001010102202021110222121100120012202020011211000121021100101211001221200001222200112222211220221212211022104-
420000022102020021120022001010201022111121202212101021210201220221010101010112011021222100010220100221012002020212012101101200011101022022122020102124-
420211110220111221000212222000202011210210020202220221200211002011212021000121000100020200021100101121102100002222011010100022101112122201101022110224-
410222120100022021201220010022111001201121010122012202112002022011112220112012110010020001020102202120011120020221220001211202200222212020221202000004-
421001000122121120000201200111222121011102201012022100122201010110120101001112112020000122000100201120200111021121220200111020102112101112001102112024-
444444444444444444444444444444444444444444444444444444444444444444444444444444444444444444444444444444444444444444444444444444444444444444444444444444-
