444444444444444444444444444444444444444444444444444444444444444444444444444444444444444444444444444444444444444444444444444444444444444444444444444444-
411201111211101102022110112102202101210100101221012001101101221200102212100111111122111021200112122111100022000110000210120101202100022110200002012204-
421110101211100220212020211020222100002022210221211010021022021010100202100212000012011102200022022110000022010200212120100221222101210002210011122124-
400222002022002021210101200202222121102222220011222222001222012101201002112122201121120000221101000010211012212002000202111112210212012002001220022104-
412101221101201221200101021100011200221101101011110022221021120221212022212102010111010101221120110000001202201211120000002211012000221120121122120114-
401222211210122200222120112212121201121220001001110201212000222022002011010010021122120210211121121010120000120121010202221202002212021010220000211114-
411001101020021212112211010011121022012001122222201001112110021102220022222010110020002222022001101101221222001112100121120001111202111222111102101224-
421100220101121102012200112111100100001021112001202112121122122211221210210000111102222110220122010221002212212001001002102100111020211212101022221224-
421221102200120022101002222202022001100202202002200022221220022212120122222221120002002021222021110212002101202200212020002101201122122210210020122204-
420212012122002201201002211110111210201000101111111122201021101010211001220011110102110220011000122110222222011110111222220221010201202211021010222114-
421102021110002001201120121220221200000112110020112020010101202200122011112022220211000022211200110000002211021011222111022202121101101210100211020014-
412102112222221222222120120121220022021202211011202222221000121000110122112100021212000022202100020020202011110011100201110201200020120101222221220224-
411110010001101211111001011201001222001110210100120000212102021121002100100022111010020211002200000202120111102102021111121021010220201110012002211214-
420101202020122202121212200021211001022201211001212010000001222222102000220022012011102101112020200002012200201100121002020011202200200221010100112024-
421121112020000112222112121021101222000211022210210101102011102221200120202220202101201000201200222001222221012011100200110201121022120210110201220224-
401000122220201202202120221112101212202001011212002020100120212221021122010110111011001201011010112122202112000101111111001221201211212122021121120014-
401222200120102012010222200110110022001210201001000021201112010222102221022110202001012122211121210200102212101022022110201002220010201120021121212224-
421210022002120110221111000110101222101212210110202202002200211021022002010021011112122202011120110221120211110202012211022101100201112110120222211024-
411112011200121111110101111101202220100022200102211210011101111221101002020221211102010121211202002111021122000102120100012101011101102222022222001114-
402002212000001001101110012221011020211201100001200110201101100110010211212221012002022122011101220122210022221100201221022121120220002112210212101114-
421222122012210011200021212222102201102200112220202202202012002020011122000101002012212211000021110011212201222022112211220212220010210101112221102114-
410110211110220112110022202100121001211101202022201002120020122210112022211112202220021002202202021011222222220102211212122110020122002112202201121204-
411121100022012121021201000220211012200020002011100120202022111211110222020120100212100212011001210021222110210020200112012220022001120021122012021004-
401021122002102101221001122000122111201102221110210201101211100202021221220002111022211211012101101020002112110220100201120220100220220210222011121004-
402200011202101102110220011121001211221022021011111111000000200110000012012000122121001201010211011211201201102222100002222011100222222202112021022214-
400011210221010100000012210000200210021220221202212212220100012120001201200112022021001012220022010202210020201122202121111022211212120002211100222004-
422101220212111200012112101221112210222121000200010011110122110012020222001020121021002101002200112122100221222000120120002112220121002220101202211124-
400112012202100112101012010010012002121220111202021000101012121221212001222110020001022212200000121220202002002002120200022120211211210111112111012004-
420202112200121201011212220020210010220122022212220011010101122001222101102102221121010220102011200010010220101201221211002120002010122221020020212004-
410202002012102121120201100212002102002021001001202222102002020211001011000021001112222100120200000201212121021122010122022012112012220111200220122114-
421020210212101222012010102002201021201022000000212020200201220001222100221102101100121012222200100120220100101020120201022110110121220211102101202124-
400120001001022021212121100121022121012222020211002002220200012212100012220012002102112002020112101122122120122012020002022122020000000220002201012224-
402212001021211221122211200220110110121212112211120102011001110200211100011110102201202221002022120110120211011012210200222210222102121212120200002224-
410200112001122100100102111011200120112102210010122210021100221002120100010021020221110100020010222122112210020011220021220220202201200111022000101214-
412012200202101010002222202100001122221210211122102110102212122011011012002002211100221221200111020212221202220100202211220120021120022202101010122114-
400001120202010221211121212010020221221001222110211120222202212120022101110120121211221012110111112222210212022122001110120010110102121012202112000204-
422112002121012221121122111001000001120101010012022120021110020221110201000221000020200222110000022211121012122221101022211121101022011102120122120104-
422110001210001021212022001010200110010112212210121111112202112021120221200101102200220201212021021020220002021001020112200211111210102210120110011214-
412200100112221220000201022000100110220100021012212000202100001012210111021221002000202001202112121020110200000122000212220111122201020212112122011214-
401102021000211020020200120220002011202122221212201121020111222020002211020221210222012111120220022101102021012000220020002201010110000021201202101024-
412020200101010022220221202100012222202222100022211200120000021121111022120212101002122102010222012022221001002000100020111200120111020012010000100224-
411111200021221021002122112010221101001101012022201121010011202010122020120202122212120020012012121002210222201120120012022002210122212221000001210104-
412000211211020211122111110112102202101011121010120220100020111112021101101120222121000221020010101001200020110210110120121111111001111220210011202024-
420201210200100102020021022002221010012210112222122211011000021200121020012222222022002122122001002201100202222221222120010021212112111121011201222114-
402212112022000122212112102022122100000002002021100021200211221110221212102201110101222110202221120020121012012101022102221102022121001110001121101204-
421102120220021202122121222002201020022221021020110202022002022201011111101111120201101012112222001011110022000012222012110002121000001002211212212204-
400012012111010000210220110021221110012020201220001120001200001022012121022202120212212012021000112111101112101020210011101101110221010020201111222224-
420001202102102201020101002222102111200110101212210202002000101200102002001101202011100211210221022202021111212211110221201121221100021002100120120114-
402000020111011020022221212020102122012110010212201122200122000121111022200021102010220111101212201222122211101001220201101022002010211111002210020004-
444444444444444444444444444444444444444444444444444444444444444444444444444444444444444444444444444444444444444444444444444444444444444444444444444444-
