444444444444444444444444444444444444444444444444444444444444444444444444444444444444444444444444444444444444444444444444444444444444444444444444444444-
422002111112211111221122020012002102202211000220022012022211021120001220200012102101100101210010101111110020121010220022121111020211222111002022021124-
410012000212220111101111121211010102001101001002201211022101021020202121011120010001211102221111121002212020112220111221212012111001112212200212021124-
421021101100102120200200022211210000212102001202112021202112120010202200021010111210210201022120010211000101201211120211202222021200012200011002202224-
411101012002221212222112000022202111211220121202002211101210220211000100220010110110100221120212110212202220121020102200121122122210021121201122021004-
410020022102102002102121220010220101211112000121001100000120022201200221221102012101100122112202012100202110201121102212201002201002100112101200022124-
411201211022110001111100110021112111011200011202021010222011211202010221212201000221212211012200011221202021011000120121220211011110222211202111221114-
411021201020000101002201112221012010202120201201220021001122200220001220212200121120222122200111122020002021112120020122120021102210022120122211011024-
401021011121121111102012100011011111201101110220011111211111020110101200210010122112021010120212011020022112211111022102111012100021102011012112021014-
411122201121000101220111211112220111211021211210102212210200221210210011212121001121111222001021110201011111102012220001111211111021110120212102010024-
401220121002212201122102111121010011010020210210102110121211202021001012111001211120202112102011102220210100122202022110011102222010200121002120110224-
422010011212001111002110011101002001011101010210112022000110112122212200001120011121000102101110012012000111222201000120210012202110002222210200111224-
412211212022020101122000011022202020122001201002102010102120012022110111000012000110011200210110100201222110010101212100021112201022000100211110202024-
420012001110102011101122001201111122020121111210112200020102001002111000020002010001200201222022002121112021022200122222212111120000021012110000220204-
421001012101212211110001021211112020221122211002102110201221000002002111121122221220122022002022101122112122121121200200012021222221221210112102120204-
420201222002201011021000011221022012020102112121020202220120020110011102021111012002110111022211101222012020201210100122200220020201222012102120202024-
412211121202221121222122122112112201021000210100021021022022212002122020011021002220011200121012220100001121111021112110102022001102120020001221212024-
401222020220211000001102112121112112210112220021002102212110222100201011010101102011212211222112102102212111000122110011200200012001112101011220101204-
402002200012000111112002010220212011102110101112100021012102211120211012212121100011200021202120002220122020201112120021112222110022121220012102021014-
410021012121220101222210102122001000002222010011011222200111022100022101110001212000212021101222201010010102120000012001100212111121011121102110211104-
411200211011022001102002111022210021102120122120100011110010201101100202111221211122022100022111221201120202102000021012101220112200021201011111200024-
410212102020020122201222011100021102110200012121220012000120000012120000211201001201010101202222002100122210220111101100212120202212011112111221211104-
421001121122201212121011201120220002211200122100000120020210022201111000001011112221200120220102011202221012101212101011202212101212102110020200021104-
420220211020011200002222001101110100121111000212112010021210000112002022220020012012010200220121200022011220010001100101222101122002022221000202101104-
422100001220112011121100110102100021220201211120112012220102002110102211002121110100101201120022202011102121210222220020200202120110020202222112112204-
400012102101102002020111211102021011102222120011002000102010022010120021202212000112101201221101211000101121220201210221012221111002010020201002211014-
410022022122212200221202011222002202210202012200222110210210211200220210012111122120020102120201121212011000201122220012022020000011110011122122202224-
401022102000210012111010201211111010122121022020110200212210100000112100100000201221200020221102111220202210121211110102220112011012010101201010222204-
410221202211011211102010002212222000102001111221021111001122201002111122211220122200111110100201020102110112120002210012121002212022202012222210010214-
401001221010011200001110201120222122011202002111010201000112002222222002020112212021201202200000201202010011212201011102021112100102022102201022020224-
410002112210220220222020220200011001021210111001221211102202100122210212220122002221102111000111002011001022120122101011222210002002022022222101220004-
422202112022100201222021102112011221221210110221202111021110201122020100111021201122120202202111221222221201121022201000001111010012000022212112211204-
400121022100111002000001212012002222021221110201010200222012112110122021112121021000111211000012122220022020101200201111020011200200210220201022020124-
402111200012202010002201110210210110011101002012101020022210022011012122101021011012101200002200000222110021020222001120011120121222200220021000121114-
402010220102222201211121100000201202100202212022022210100011202212200011001100211012202210111220120120210011112221000120000100201102102101001221012124-
420211121112001001111200221120000000210112020120200220011112000010202011221111120212122212100102210122100100011001022022222202102221202222012122201204-
412212121000202111001211111122000110202222211021102001221111220221100111222212220010021011120102012220120102022221201002000102020022011002020010002024-
402020220222110101121112200212200202100000222222222120120101022002010002010210122111121222102020011120012220120202210022212222021101200002222211221224-
411012201211200102202120001220021212112100221012102002212222020021102020221112000111210112002021102112210221101000120221010212110010110022001010201104-
412020000120212221000112101200001212220110222120002121121002210011110210221221202121011000221211111012200012112222002211012111102202020220210121101014-
402000201001200202221200221020022011121101121112120101100112120210022002012011102202211122020221112222000020011002020020102100101122010101102022122214-
410222102201012021011120022102201122012121020111112010222002020211112202122121122120111020121022212021220100102222000202220212122020021222201110022204-
410212211110111112211121120220000222210210110202220210212010211222010101222012020001020022211112202121122011201010000122110022202110221210220001022024-
421112002001002000021111102001002122112202200111020202012002202111020000202200012200011100122121111221112011011000120001220202222110101011201222202104-
401002010012212101211002000000222222110202220200220002101121222222101002110211112022121000020111110010100220201020201121120211122200101000010100200124-
422022111212001220021102211110100020002210101020110112000201201100101010012112010100121210220010221221200111211020222121002010012000122220112020212204-
422121020010212122011020021001121101200102110022021110012102112101122121120101221101000122110100200002110111202201120100202212020120200202100222112204-
402222022021221120010010001221101112222121022202201210020002102021000111210211100002220011122021011102011200202120212000100212000102110221220221021114-
422000221220111021012201111001110002121212220001210112000221010102021222020200010201211200002002100100110110212212201201010100011022021011201201121214-
444444444444444444444444444444444444444444444444444444444444444444444444444444444444444444444444444444444444444444444444444444444444444444444444444444-
