444444444444444444444444444444444444444444444444444444444444444444444444444444444444444444444444444444444444444444444444444444444444444444444444444444-
401021111212020220210022121020010122001001202201222102001020011111211012102010122110100020210122010020210021200000102011210120112101221020122100120014-
422011112022002001111002211102020212001011211210200202010212202022212220210101222100222221111210200221022101000001200101212011100111201000100101212104-
410021211111202020200210021002000120100220222022222100000211000110202120212000012110211101111021022121011111222010021212022212011102210100011122112014-
411011000121101201212111210212222020200110220120102101002102100201012202022110221201200201212212202220000112121021112200101121121000210101100020121224-
401200112012110022021020002120202111011121011020101220102220012210201200001002022102102022202111220102002021111021121201222222111012201120002120120024-
421122202122101112110122111122112112122022202021101210102010021011012000111201102011211120010011022222210111022001011222201102000001221201020120201024-
420001210010221120120102011200211021100100010222121022001210211200120101110100102100122212100112021101210100120012012021022210010002221011001210220214-
410122001022211110000012120212112112221112211002201210221211221012002111001212000201122220020002121222120022121012202210100111221022010101022210110204-
410111200220000211210210021212112110212222122102012001210020220120021010111010102000101200122201012100222110211001120110211022121021121022121110100204-
412201210120012000210010201022002011121201122111121122220020122020111200010112111210202001002112022021121010112102101212021101210201102202000100020014-
422012122000202102122010122011021220222210012222211021121012111121122212100112201022201100101021021002102222200012011021210122111201101012002002212214-
421002121110121110201212111021202000120000012220102201102122211101011022212222200201002021111011110121012100000222001202012010211101011111010200101124-
420112012122110011012110010000100212000220011111100020121102121121022211100100010112010020221210102112221101001101022202202122220201121100222100102214-
420010200212110121010101110122010220221222020221022112010211000012100200210010000001020121020022010110001110122021212120221002010120002201112211220214-
401010110210221010112200210220011102010102112112211221002110212002210202002200022220010212220110220202201112102021110202120012120101201101201222210014-
400110210220001110210122221112122012002002000012012122220211011110000221012211210212022222011011122012001110110101110222210012202021220211011021201114-
422000201121112001120002221111020000202112020212120121222200000121101201011122220110202102001220022021021110211212021021022202212020222202122000001224-
411210221021112002211200221101100021111122000202021021100011002011112122002012122122211210002022220010020212210201102000202020222021002210221111112004-
410020212211220212001022200222101121011220222111222020120000221221110201211001122012112102201210201000122011002212200010010200201110112002110121111024-
400100001021101101120010210100112122221022111020111201021002102002101202220112011020010210212000012202211120222122021002102020001100120011022001100004-
402111012220220112121010000000011212112201102010000022210010021022122220200112110220120221211212020020122000211220121000121012011212112222211021221004-
411122012002121122101221100002001000222211010201111211122020002111212010220112121221200101100211212202100111010021212202211012012220112211010122022204-
411010110200122002220000102222111022102021022222000002110112001002121120011101211020220111021111210210101212220002112022110000221221121110111022201024-
412211111111101122221122212011210202120122012111000100022020212111010120022001001002001102100011200122120221000001210221122120010102001212201201202214-
422220111220202102210112112002201012112011011102001222111211020100210001121112002121011010222001200010200002212111201120120121111002022012221010110124-
422001221022012220110212121221122010000211112201010201002100212201012200222002212010002210110012002020021111112102001121210212211101101002212011011124-
400000111020110020120122122212112221221012011020012011202110212002011211021022002102212111121200121112100010011002220021102121021111000120122100010014-
400200000200022221202011110201122122021001200210222202121220112012210012122002200210101120201120012212200220000022212210212201111112100222212102100114-
410012012112201121020202122022211122210021220110220211120200212000220110220021010001022000211020102012101111021101000221122012121002112212121121010024-
410222200220102021111021010200110021201000220001002102010102010020101221102111222212101221111212221210010220000211210202100120100201211001122221001214-
420001011001020202211011210011111011022111122022102122010001020000110102201101202121201201200100200212221111002120212011210211002211211212201002012204-
410111200200022121011122021001210201222001021110001111222101122200122002100010212102010210121200021120021201110212010001011020112000201120111222110214-
411121022002120111222120102120211102120022000222100121010111100121221002221220211200221022002111120102022221102001102221202212122112110202002221122204-
412121212022010011011021000002121010212111122111102221112211011020112122001020022122102210010222200102201202112111022211202112200121012022122011220124-
402210121010011012210212111110010001120002200012122122220110102021102220121000110210012110100212120112011222020011201101200121012111200212020112110214-
421202010220112110022112020011112020210122011222022002101220211000112101012010110011001001001120120221011110220102210200120222200201221021021000201124-
411120001121100222111101100120122210102111021012021102210121111121012121101020102202200111112220021220012221221201122121211201022201020101102101000204-
420122022102222222022000110021022121012110020101102120122012200102022201111001210220220211222000112202020112020221222221220202222220211010011000011204-
412202212020111001200202220220011011110111000020210222120022000022202212022201002222000110002210222220200011212111020200002000100101201122201110212214-
402210012220210022220112212102112011211120022002021021121111212122122012012110001010210011001102102022011012022221020011021100110121200221022002101014-
400012210100220101011221210210222212222020200200121112202200120012000122102002210112001112121120210111202010102021000220121110102100020211100221100204-
400001020020202121212122202211002020122202010200012122211222002112120000111022101111001011110010021012001100010012222111000121212100100120002110222114-
401212220111021100202211210120022202010202022121102211110201211110001110210221021021120210110002021220221201101100120101122112212012021121221020112224-
402000021120012002221222021201100001120202022121011211110000000021000111112120012000022122001111000210111201122122211012010112111100210201022211000114-
410220210110121221012102111002021210200020220121002202021002221112102020221020202202002101112110001212010100221011210021211212222222020212021111000214-
402101221202110220202202100201210110220211001002021201120002101101110001200121010121012101200122222222102021002001121110001202200222112102211111000004-
421210221222020110122122222210022121021211122112020201200012202121122221002012101211020221112101201212100121211121121222201010212222222011122202201014-
400111202120222221220100220121221000002001001021201001201021111021002221010121012210120021021100011011222212100110222122122012112022001200220000110024-
444444444444444444444444444444444444444444444444444444444444444444444444444444444444444444444444444444444444444444444444444444444444444444444444444444-
