444444444444444444444444444444444444444444444444444444444444444444444444444444444444444444444444444444444444444444444444444444444444444444444444444444-
401222002120000021112111120221101112121001101001121101222002000110121000010012021010122121120022011122020111122111200120010212220100122122101020210014-
411111120201222002020001011020121200202011121212110200112200010021100211221000202200021111001020111102022000101000221020000221010102120202102021210204-
402220002011022222222201201201111102222012122220012020021100212202201222221022202002202122021000121102211221002210121111212202212211110122101210001124-
421210021211000011111220000221200222112122100202000101102200201201120000100101010201012012101122002202020000012112112200122110010020222222202120212214-
410002001121200210200202201022202102211211110122102202010012022221200122222022112101101112110010011100100122221221011002201121002102000012001011102204-
420122020011201111201201200022122220211122122010221020220222212212111210111212220111221211010001011111101220102220100002200112120221121211201200220214-
422121122020220121222010022010012210002222001201101122111220000210100022021201010102110000100020121221200112022011010022110120022021022021101222020224-
420102201200011201100021102222101000122202201201012212102210012112001021222212110001220211011111201100221200201221002011012211200201122020122222001114-
401110010020121011221100202212212122101112110110111212212000111222220120111120100102010121111111211222221102210002211220211221002201121022200100012204-
411201122012220210100112200001022221002121202002221101210222000001102112022000011010212120202121002212221000111022002221202212121122100222001012212124-
420200221210221002020011102211212220200101212002101201222200002100212210100200122102020211211201101012022212102110120121120002110020202010202222220124-
411202012201221201120210020212012202200012011021012202111111101112112202201012021102012000211102211000221002222222201221211011201012121001110012120104-
422012002012101112112212220121222121212110002210212012012112200200110001010122002011121100010110101011121120110121022020120111121200200210020012211024-
411011112112100202112020222111201222201002220201101202202002100002222000221110110022201120000012110210101222012101220010100012201220111210210210001224-
412010011101212111101220111222010211120210100001000221011102021120221211021110101200101010021111000011020112011201110100120111021012002222222201120204-
412010011202110212200202021202102022022212122011002021102012002222020010212101211100110212200200022012221002222010201220002020110002021220021020022204-
412201120000011111102021120201101020110100211022100112112102221211220110210000021212020022021002211112210110021121200120202100222110010122200121001214-
410101112222212020212102202010112100201000202022020110200011012012101111210011100112212100022012121121110110220012101012110020121010012110220002010014-
411100120021022121102002011002201100221000020211012011021022002102010010120221000211201212021212012012210221212001120121220010211210021010111100001204-
422101201012220112210210120012221020010100002102102120110010101211102021121102221111120010120000102122212201002011220000210001001200000220001010211024-
402211221011122222212011200020110101111122021121022200020101200121212012110012020220120201102022220110011200212120010201111212022120211112210200022004-
420221221111222222022212111122210000100020020101212000211100011110110221111222121120210102201111220200221010221011002001120022210220002022222110222124-
411120110221201101002002211211011101202010012011021010220222200200220010210012220201000021020121202210221122210220101022002200212120011112211100211224-
402110022002222220220001010010101111011101100202112101220221110201000202202110012102001022102121001012200221020222102220120022200112200200022120222104-
411102012101000200210122120000201000000120211001102002020110120020202001101202012210001002012012122010122122120110112210020110011012202002201112000114-
401202111200210222112022200202011122022201021121012022012202001200022212000000012002221221000212201121001110022100101221201210210112220210212202211204-
410012102121001202002011020222121201122101012001000201222001111021200121102112102210001101000002211112112100021020121012021200011200020100101100120104-
411001100102200012022222120201010110122210201211001210221112011201122010000102121122100012121102022202222211021102120121100122202210112011201121110014-
420000110122010201020102101020112122020100211121101001111100021100000000121202200021111001022201120121011201200000120221011220001001000001122200221114-
420112122102020222012110210200012220100011000212120011221010212022212001222200210111220020020020202211220001121202000002222012200211110211112010010004-
401222211211011220221122020122200101211111200121120222101100020102120202100101020102200120022220221022221020221021112212011210101101212122212211122204-
401101020012010002012201102011012101211120202000110112011000112022211002010011222100220210221001220012122201210201100100202002010201120112002000010004-
400022202000120112110002212122101002120221012121121201110110221121020021022020220112200220200111002011122101222101122111010220010101222110022020211004-
422220020020110202210000001100212002200020022112210012011020000002120111112122120020212201002212010201021120221112120011110010220120122212101222211204-
402112202211210000022012212210000201210012120020110122210220210022212112001221112101202102021100001021012001010102120212220102012120000121121110201024-
410120001021202002022210211111200002100011101121012110020012102122111012022222200011220110110212010122101020112121100020120111202211120220100221122114-
400222122202200000221001112102102220001122201212120100102222220101210001011101121000102202122101211112100122111002101022000212011001122100212021210124-
420020210100011221011001020201020102001221001121010002022002110220210101112121221220201121212210002002000010210111002021210101021011212210121202011204-
402110112012102001012021112201222011102021222010100000100021220102112101012210210121210112222010211021210210020220110201101001212022022001120002102024-
421000000102112112200211112121112220120222010101112120111222111112120100120102112112011210111220212222111222000110212020201001202111112010111102020204-
421212122202201122120011222010021221121111220201002111120111020111220000200110101112222220002211012101212201100101220102220022110110202011020010121204-
421021010200022022111120021201011122210022221212200201102122211010002222110102022010100001111021111011022011210112100012001121010021022020111012021114-
401110202002100221220022222100022020201011222100022111210120112220000202012201022102220100111000011102010110212100001112212112012020211222012112111204-
401101112121121002102212001211210001220200222212211020021022021111211221012220211000000112102011022101220020022122222111211121020220012101112111200104-
421222121001102111012111212110202011221200002201202222211002210121100200001001001000222020022212221121000122111021110121102120020001021210121121222224-
400012101212012002002000211221122101200210222212202222201010011002011102011122102200210022100200111020120012101100222022020000102112200220112122102024-
410021001210002121010122002001010220210201222121021021202121111200221110210111121212110100020122010201221211211012220220212021101020000102101012222114-
410101021200202002022020222220112210111222200010111001021121202120100011121002010011011011021001022121000101021100010111022010202022001220121020211024-
444444444444444444444444444444444444444444444444444444444444444444444444444444444444444444444444444444444444444444444444444444444444444444444444444444-
