444444444444444444444444444444444444444444444444444444444444444444444444444444444444444444444444444444444444444444444444444444444444444444444444444444-
422220021221220022022220011122222011021222001222102211222000102002102002001212011102200100012121011000200121200221102010020221020120112100202200000124-
411102022021102120201000211022100202120010211020210012101202002011021000202202010010212122122202212200200012110000020220111010212220010022112210022014-
400010100012200102001212221111212110012121122012100211001000211100012000110000112111120210212122101221022211022211100112222201020020121222200021211104-
410012010121210011221110220012220021200112222011201212012200021122200001001022022012202110000010001200201011110100102012101002210222002021112021122024-
400000111121212101211102202011121121210001001121200201120202110212220210200110120102220110122021020112210011202112002020201002020001012110001122222004-
421100020011020201000102010112000120120111200211111222101201212101202102010200221112201201021011202222212010011022212210111101012211122021210021221114-
411102220022211000001202220011020211002200110101002100220212021101210000022222122221011121022201002121002000200012100120202200220222202202222110101104-
400202101211210001112121100201011222201200101020111101202121111020101211101111011010221021122022202202211100012200211101111121021100210120012101221004-
410100020022000022212220100001012212120021202020200220100020000002202222211101122212020120120120211202120010001221210000020110021022011110110221012124-
421212222121222211202220220111002020020220111221001010012012010222210011102202220102012122101111001211011211022210200020101111110202220200000220122024-
421010122212012121021020210022011020220020220111012121122200120212102220001201112012112012022121021101121210121022220110211200212210211112110102221024-
421102100222111122100112220012110011002001102202012011122120002200122100021021011101100120112100222202211221002100200211000220200102021020112021120104-
402201102110121110121220220101212212201102222102112202212021111001022000012202210022000110001210100022202102221011022220012102000021121002210021121224-
401101000011222200100201100112121200121221000002000022121010012001222100111120222212102210202022200212120200112110212212111202122220010222010021001004-
402122210022121020000120122002112201010202101111011211100011211001222020112112021211202222000101112010220012010201121020002011210200102002100202000004-
402012120100200110101021010222012012011222001101002210110000221222000000222021010021210021002221121120102000001202110112221221002010202202221111122104-
420120000020011102111102221200001112000010201111001211221010220200000011200000122110202210220210202001201021200211010102101110121020101221002010111004-
400022120001120102211020212011021221111110011100112122000111010200200122012012100211020100011020121120110202100120000110222110000220102212121121212124-
401221012210022121010122122100012212210210022010120200012102112210201012222002222122211011022110011111111101222001222020021102201002112212112020211024-
421211202112200100000002212201122122012211012122011120202112100012022122010022220022010122122221022112101202111101001112121122122012211110000002202004-
422202201210202211212000200001212022112120122101012200002011022020211010122001121211200112200221101012111221110000010011222120202220202122122111022204-
411112101211221001221212212011112010002012112120212110021010210222122102211110012111122110011221202001000011111121010222201012121001112210211021220004-
412200001211002020000101101120111022201210111111200020101122221012210121102201101111111121100200011210000220001202112100201101202002201022021012210014-
421021102122200100001021212220011110201212200212222202121200220002102101100011110121120222220222022210122101102012022122111001020010002011212222002004-
400100202110222010201010201001020011100202021110002120220111002210012121120200211122211122112000100022212101211001120200100110120201121102201210021224-
402022011100211122022201000100120111012122212110202012022110020122100000102210200122111101010211001221111211021011220021122100102022101211001022212014-
420220212022022222200222021021100201102112002000002222002101211112212011211111120020002111011201121102020121212110020221212022012200121120012102111224-
402000002011012211012010002002000212121220220211221222120212200222110220012201120112200011022112121112001122201110210110011100112002011122221200020114-
411002002112102000002222121022212000112101121102200122221000011202121002102222010121222002110210110012012212022101021021202111101111120021110121210024-
422011021121212010110000120011011100001221120001202011211100211221002101210212020120111002220222112220112102221100121101002021021221001101021202001014-
401011020222011222212200100121021222022200210210211020122222101110110101211211222022001122122220021112011001020121201210122211122021112001121201020224-
422120010011012022022021102102012102010202102220121202121021102021112011110012202201012011000210112112002202101112100221020121001221001120110111001014-
402120121001111012221212221000111002020011000221020010012221100011011012110220002102200211011020112101001202000010200100100110112101121002120110112214-
411122101102012211101211022202101002112011020020000021101110112101100021020202122102201022211200120121121200011010201021121200010100110020202111222214-
410201010120022200011020022121112002122100112211222200122021020100222211212012220202202010110120110200100221201220100022222010002122200101010202102214-
421212200220020022210110102022202121121201010012100100202222122121011122212120001012001100202220200010210111111221111101112120101102021120002021221214-
421002010020221211010201001111221201010122211011121002212201210020110121110220020210111012222101021201102221002012100011202011111100021012122210002004-
422211122112011120012121220100101211002001011220110212100112112200100221201222021002110020112211201210012010112112211200002002101010100221121112210004-
421212202201112200011100220020220100012201101220012011200120012211012222021220222221200021201221001122021000222222000011001110100001000101201001221124-
411012021011210202111120121020202222110202220012210021120210102021002101000201200112212211121002100210011122121011210000010001210010200221100112211114-
402201000011222011120110201001002211212110122210222122211201110202220112100201210010121022010221021220202022201102211200121212201011021001222211011214-
422122120221101022210212112012200112212012100001020210021222100100210220001200022022202111121120012200002112022121000222200120021201120001112210111124-
422201022101012001012211220220011202000022220211020002101200121022202220020002120120012201102012111201200220011012020001001200000001101010211120000014-
401111011002011101220112211220121010202000201002121010111212021001202111012102222112220012201121002011122102122002120002001000000100020212010121220014-
400111101120112110101122200221100021102111220220220010021100210221020101102100200202220110112101022000221110220022200000121022002001022212001220012004-
401111000210021220010210222212220200011102021112101212121012001200011011021110000200011120210210221212210122020002000211200101021201102200210202021124-
421111002222010221012000000122221212122220200210012111002202122022012111100022210120110212112022001212212111101120200121111211212001122022122001222104-
420212210210200222220112202120120022001112020111210110221021012102120110111211211120220222110202021201122100102001002210220022010222022210101222000224-
444444444444444444444444444444444444444444444444444444444444444444444444444444444444444444444444444444444444444444444444444444444444444444444444444444-
