444444444444444444444444444444444444444444444444444444444444444444444444444444444444444444444444444444444444444444444444444444444444444444444444444444-
422221220000000222110001222012111112102020012010111212001202210211120120002212010200101020222021201102100220012120121201020010101110201020012110201104-
411211220011012211120122011221222022221101112121201010221020212011212121222122010002022012112012220111221101001112120201210211211200212121100221210114-
402121121002201220122220122210100211101122121112001210111021212200021212100000200010100020112221211120201200110002202221201012020112000121001112120124-
412202001221221111202110012121211012122211101020220002202211120121002202000120100201202202002022200220010011001021022101112011200201001001202100210204-
422220002210120020222110200201120200122111201000021200200001200020010222102020212102000220102122022100122010220200020002020201122102111211210201111224-
421000102202212010020221002120001022212101221022221022220112210212020120220202202201222022202101002010021201122010221011212212102122221000012100202104-
402100112222210001202201122211220011122111202202120022011010001212120222121122120112020222022102212102112121220210101211112200011110222222110210220224-
411220220100220101022202010201001012120110201211010002220112010002011221012200120220002000210211010220222010021102000120022201100120221211222122110004-
422121000222122220120221220120100202102021221012222200022022021211110120210211222211011100202102222202020020220122021021201211101212022211012221221004-
420122110221022110201211021100122011110120022100212021011111012010001202002111211121011221021110112221122220211221000101221020210210212221201212100214-
420100112010022020201022100021222211201221200200221110212101211010001110110200121000211122221212220200122121221200001110022000002220022201012122222104-
410211221010112201101012010012121100020222122022222212221102210102102012210000210010121000102120020110020110121201221022121200200110012102111101021004-
410121220020220221110212121001002222212100102220021012002000221112110012001111011101201200002210210010212022002101220002010101121002112102222112000204-
422122021102210222022221220211110112220010022111211200102021220210111221101021010212011020021100201202221201021102010222001111102211101022222102200204-
401101011002202120222220110120100020202112100000202220202221020021002110202122010120220112001202220011001202111101120012202212011212222110202102022104-
422222102122120011010110121220112020022211022212010110021001101012200101101022100111012200121122101020101020112001002111201001010122211010121101011024-
422102111222120102000222000110001022121120100111022110012020100210111012010210001012211200220212100001212202122222121101200200210011020020102212210204-
410120121100101011102202200000021222121001022221221111111212111111012001221101120101212011000200102010211220212112100210202101110012122111111020212224-
400210122222101022111212012212121021021102202222122211120021001101011022202020002022201221022020021010201111200020100122111202100122120112200000011014-
412212211102220102200001112201222120020210100001012121011210212001011121210010122200112220120202122121011111020200012010222100202210222220110022212004-
402202121010220002211222010200000220221022001220121100021220121220112211121020201111011012002112200001120121211021211102110001121102012011211200102004-
400002202122202101021101102011020201021011010210100102021101010220100012101211000202021120202202012011111001022021022020112010212122122010121101112214-
412121012102002221112222111002202011000220200222110201212112220220112210212112102021011101001200100102212021211022020222120100222120010111101101100124-
412122221201210212221000001212010112011221212121012212120000020102111210220022100011012211121210101200200122200210001022011012201221120201011102110024-
401221010010111201112201110101211111200020010120022120011022122100002112022201011200201211102101200111011022212112222102001120120110002210101222211124-
400020002201120012200111212121102111012122111112101000000021001111111012101211002012111002111102102120001210001212102201102220201121011121021210111124-
420110000010201001121012122112202212111010202202000112102202210000121201222102202120111022101101022210200200200201121122200000010210111111002020001204-
400102112100201001011102221021010010222020111201112002020011121121120112112001001022222220012012011120021100122022022010212100001102010110212020122104-
412001120102202120002110222202112012211220001221120102010121210211120122120211210002010202021002001021102212111100212002222111022000020012110001111014-
411022200121202220120121101201021200121011212110011122200200011111212122022212002102122202002221021211200000222101001021120210220122112012212200210014-
411012100120201001001002221221222121221121002120200212202000212022211200020120120202212212201120002201021111111021022211222221202021201122121022011204-
400001121211010021211002221010222021010102001010220012001002012110202101000101011001120110110011020022110221200021112120200020200202110202120102221004-
401222122121102202011002112120022200111122002222021102210121110021111201112012121002000202102222211011102222212022221202111001012002012001110201100024-
422102110221221022112012122221212212121220010010201101011022012212010202102122110101011120200112000022021022022121211022120122211100011220211112012204-
420001110220221201121120112100102200110222122001011011122201122100100011202202120221122101120122111211010110210000220102221202202100200121200011012124-
411120022220222010201000210201120220100100122111211101120120112012222200210122012012101111200100200001110021122012211221100120011011112220101120021104-
400011121212011001120011122221022111110120212010220012222201002102020122011100211221021201222212210112000102120112022221202021222100212020201201002104-
400001210011001202102000002001001110212001200112120120122211000121200212022112022121110211222121001121202111200121000022212020010021200001020101020124-
400202102212222022020111212002111001111000210221211022120212220112002111201010110021210002020201222210112211102101200120201000020202021000120012112204-
412010211222221022121100201211102211112012110101022022102000012000011011201112101102101111100212222010220001010200010020012022102102211012101221011214-
411111100210102211212200120020011002000101121110110201020221212200210022001222222220112101000002002220011121222111120121100222210111220202212202200004-
421111000211202022120220112020210122001102001221021112001100110012121001010101101222110010222210221202021102111112110021201111201010001120221201022224-
402000022200022100221002000112112102220120102212001112002101102210001020121200211002111010211010111211100100120201121001002002122122211211002222011224-
422121221212020210101000021112220010120001212220211212121110200122102120212001122000120202102221222210022101101202201122201100011200021211100022022124-
400100002102222022121210111220101221211212112121212220120110121122210201100011001220200202210201222122012001010112102112210110012001002120112001210114-
400122110022222100100012212010100120002001221122010011020211201202121211001221111111112010202111112011122202112000121122212201200010100022220202201004-
400202112211121220011212022012200200020010221212221012010010200102201222000020020020102010102202210111200110112002020122011021110211011100122002002114-
420101120210211002022221112000222022202222020120001001100000021021200102102022002212010202011101022102212100112121012001221012000021210101010100010004-
444444444444444444444444444444444444444444444444444444444444444444444444444444444444444444444444444444444444444444444444444444444444444444444444444444-
