444444444444444444444444444444444444444444444444444444444444444444444444444444444444444444444444444444444444444444444444444444444444444444444444444444-
421212112220200101121002002112212201200000202221122122200200110010010012211112101111121000210221012100022201012000002001120210111211000020222211012214-
401020021022222101022020100001220211111122202020001102121220221222001220102202112022001100022012111111211110022122212220221201022022212010011122212004-
411002211211122020121012220112201201110022012002121011222220020102002022022011102010102220101201000222101202221201111011212100101212202111122101111124-
421210111021211021010012022022002002102121010100210211020010110210020020002011110011100200021111120022012200202020201021010101020022111012020002111214-
400020201210111101012002010122220011001010102120202021202112201212110000012202201121010221002102200111010221112211000211110100212112210120002202210214-
422001202011121221100221101022022220212001021011210022202011111100012011201001011020001100020110021200002121112200122121001001122121110022110122111004-
411101120002101002201002110220110200111101010220010001111120222112011200220011120220221221110222200200021211012110111100110202210221121222121221000004-
420222001111021210121120021120021221121021211200211200222012120122201212101220102122022212000101100012112112022112212000122201012021211210211111022114-
410001212001212112001002110211101020121210201220002220011102220101112222211120201222122110212000200101022221002011212212121102111001121000221121111224-
401022002020010211210112121212011121112202111021120001000211100200210222101102102022022112122202100201010112221112221221101102122220022211000202201124-
400202210220120010210002011020211211221010110210121221221012120100100022100221112012202200101200210210200201121022010111112010001200201022011010022214-
421200211200012002101001210012102222210002202021022120110101111100111201221100220200110221020120222200200110011112002222222221011021001201222000221214-
420020111021101200002020110120002110202021220202112000220102120021020012201201121010012122211202121001022011102021112110020020200002000011111201101024-
420120102011110102001010210002010102022212101011110011012022222211010101222210200202210121212000111222222210120120112200121221212122210112121020020014-
421110200021001001220101010110111110011120120211202100001100110221020012122221100210010220110010212210200021210110012221202121222102012001000000022014-
401012220121011210200022002021001102210001011111200010121000120222100120200012011210002010211211221102022010220100121220100122111210012201000201121204-
421011110111021022121201121111120012211102212210122221122121102210112100021120022011012011201102212010102200111200022200121022102112100012001100110224-
401100202100202202112211002220022202021102102002120020112020102001210101010121000110111211211102212120102020102222121110222001210111120112201220002124-
411110102000202001011102120220211121000022000000201121000001221022212010101120012212221221220222121022202100200222221000220101020201021222211022002224-
402221100022000022012022001021200020022210100202220011212211012212022000221001220122210011222102210110012201120122200120021220121200200220102221211124-
401012110120122212012022121110010012021100100212112200112021021210020020001110111100220122110012200122020202211210102120100000102010102101222102002214-
400221210221210220202202120010021022220102101111002210002100010112201012001122122012001020210221111102122202121200201101111200210111000122112122021104-
410022222102212200222110111200000102011011222010021000021222100020111010101000121222221221001112002101110210212200010201012022110122202221122102200004-
400210211120000210121010011112210001220022000220100020110112002001202202100021222101020010001002020220121112102220122221121011201011112111102121020214-
410100212122120200100211011111012222000002010022220100112110221112111022212001121220112010120001012220212000112210100102020110121102201200222100112024-
411101022221200101121111122122122100200110011002022021221021012202122212020202211110101121212110011112220002221102210110011110220201102221121122211104-
422101101001102022012001111011112120112021000202210211001200121222010210220002022221102202222101221102212102201102002020012110222111202112212121020014-
401212022210122210101100021021202202010022210022200012020211120221220222010200200000201111211102122020200100202020120110212212012011222102110212222124-
412201122211000120120210100211100122002112212122111210122002022112112000120120022110020022202021100202010100200112020122102110121112221000021220211124-
401121212100011102102020121021200212121212122202201211111111102001011121101121021020021021002202111010222002202111011102111221222021011120112001102014-
412020122102120101011210211120120021000100112011010112200102122202222002222021212211111110212011122200002000001001220201220112202022102101212011101214-
401210121101211221100210101200102002002001021221011221120002122220221120221222102101021222212010011100001110020201012200201202121011212202202100021014-
411021211102002021120210200002120210011111222222001201010002122210011101222022020201002200220011201102112011201220011101222112202102010001100221000014-
411100010121211100020022202110102002022120220202120100010221001100010111020220221002110112201211001221100122200111100211211111110100121222111120101214-
420211100212200220020001200220112210000120001202112000021002012002001010220002120012022000020101002002111222110002111101202021012121202102001002012204-
422210221011120000200122001202020220102010120122010011101201101021222221112012100010010100120101101120002202122122000022102221120010001022120002102214-
410011020020200210002120001101202201122202201121100010111011100122220002122020122110211222220012120120210200221020021200000010020120210001112201201214-
411211001122212101111110120011120201101001200002000001000212102221112120201201220100002221202021221000122022111020102222102102012000202022112001011024-
420022110011020001010201222110222001210212012000200100200112111110121011110021002120222121211212011202212021121100112021211112121012011210120020100224-
411202121011101122211012001012100021102101101102120202221120212221212000200111000122201221112112210210022121022222121111002012001002112120100122122104-
412201201202211020101110020220020112110112202220110211210100112212202221210020110001000210200010000112011001001100212222122222020221011111201212112024-
400011211021122001000210101021111010210122110112020011002200201120201001000110122210220002002212201001122002211212220110210010112202202112222220111014-
401121010221121121020112010012211222012121020200110211020212122000101200020111010101020201200212221002121221110020112221022012220111100200120011002204-
411120002221020022011010122110200221012200222222222100122122020002000221002220011201020021100211202121112011001110122002112020212020000020011201122224-
400120111212201122101122000010021211222112221202120000012220111120202212112101120220110121000220221012102122222001022010101001120202212222120222120104-
420221201211022011212101202021222011222010200002101021201020122022222200021001111022211202002021121212101212012222220221210200220012112200211002100224-
420201011010100120110120100220212120121022020001212112110210110100022100020000002100222221221012101200011220101200210202202002122022112020111001221024-
400022011012200221100210021210100120202010111012222021121020101001201211222102021002112210122011010001212212011201201012021011022100221021002101111224-
444444444444444444444444444444444444444444444444444444444444444444444444444444444444444444444444444444444444444444444444444444444444444444444444444444-
