444444444444444444444444444444444444444444444444444444444444444444444444444444444444444444444444444444444444444444444444444444444444444444444444444444-
411122100202022200220021222021021111120202100210012210111011222000101101112000200202010201210012211200021100122222122000201021201010101022210000200004-
410202210011011012100012021122112020210120222110001000101102210021121221000100111221200101221212022210020022101001201201022012020011102221011122221014-
402221221010222221122001122121021002221011010111021221110011202010220100122001221121200122201110100222202011111201012121111220001020120012000101011004-
411122101211020112000021110212111000201201122122121121201021021211022111201002002010002100200020111100002110020011102201222210122102212222010202101024-
410001002001221202100221200120110212200000002111012010100221100122220222021020120010211110110102001010022121121120221022022101000121212211121110200204-
410011001020002110101221200010012121210012012122111101122110110120102200000020211220211220202201101200201101120211001202220011011122102211000121121224-
420000102122110001202010220011112121122111220212111110000002022020010111001012220012102222011211100212111011111122110212201221202212020111001211211214-
400200221001122202202120122220010020011102111021201021010110200000021010120111220010100221121111221000111112101212022001100122101121121210121010210004-
402201220110100201210112202211101210121211202002100222210122221002221022010110201101112011000212200200122202201020201010120112021002220102122002121204-
401101122220200010000102111121120100021212202202001022201220201100221002112001220020200122100120110211101200000202001111021120110212212101100010100004-
421200002101202110001200020111112010021220110012220121222010201201122002200220020110222120110012220111010120201121102101110110222222011221222020001204-
411010001010020002020100010022221101012111210211102001202211002011101021200202010120211100111101001101100211201101112200122012100101201110212001002204-
410120111110121112222222022202022211102001212112211002000201111100220002121001100100102002012122100121102001120122222021201101102011212010210112211204-
412122201212211111112012022012121100111101122200011221220220110102102100110012222211200000012220200110201120120210211212010022121112012222001102200024-
421200022120012001012110111112212012021111101202121220101010202002120021120220110201101122212001221202121210212112112211122200100011221120020211102024-
420000020200220112120201012112101110010002000121211221000100222122220122011122120020020120012100002100121001112202000112120112021020020021000010122224-
420121221110110220122101200100201222100111121110222221020221100001021022121020101112212111220110212101210100002122202212022212200100112010100102101224-
402220010001021221011122201210201011122220122020100100010102021020001110210022201121010010122021122111002120122001201002020110001021202210112200221124-
400120200100000002211111002010201110211110022122111111001121121000220201200000110020220201020022111001221012101022020202120210002110120222111112010014-
410020101120110121021112021001212102021002020111222110212201022022122012100222222011112000110110201210012100010202002012022110220201222111200120201224-
410121021022202202102200111211120011021222122112020001022002020201120000211010111202200210110212120120012102112222221101002120121220002002102010222214-
402211120002011102211122012222012221201021221212011220200120020211202201101001211002201012211221021202221211001000020112020222202210122011222022102004-
410022212212212012202110102220221011221022201011210112000222221121220122011211122211220200121001120021011220002102021112121221120110122201221112110114-
411011210222002101201202110120010202010022101121000000010222121202102222110212200221021220022012021112200100202012021111122002010020011020120021210114-
420220221020100202010210201002120110011000222102020212011210210211100101212011121212120221010222211120221001211200220120221120120210020020021120212114-
410102220021122221200012212221000010022210212021021022011020221221100200000020120021222211101102221020201020220102010122222200002012011021012211222004-
400221100021111010001020210120212000101021101200002000202111001002122112000020021222221221000211010122222021102011001120112000220011020012021121120124-
400120202102112202011021022010011200200200210211022201202110220222111112021202121021110021001010102002111221222221021010011101020210201212011212221014-
420122210211210000010021201021111111111221121200121102102220211020111222100121201001110022212212012011111010011210110111211220221112111122020001212204-
400020122101111200100121122111111110110010112012211012000220201200021022200012212202020120112202220211021202210202220100012220222202000022120112210104-
421022012100001122120112122211210220000201100120220012011110020022200022122220210222021120210201200021202200210220211202002122011210002220200100212124-
411220100200001120221201111211002011010221211210022102102221200011121120122010102102200122122002202002022121120220120221000110102010021021101000222124-
401220022000002212212212121202112020001220110001111100110011120121020102011001111120100000101122110001000012220121021122220111111112011221010122012004-
412002220000120021021012001201111012111122210211122120121222001102220002200000210112212001210122202211220120120000202020000122202212011222120002202024-
410011101122100210211120002102200000100120112210112112001121012020202000110120010111200120222001202000101022222102021012002102001212120002002211110104-
421012100220220022200000102020020001102200001212101001211212111010221100102110200210001112112010002202102110002110020011100021212101010110001002012214-
420110200111010012012000122210020111221101202100122220001022101202100022020020221222200001012012111211200000211212221012200110121110101001002022120024-
402012202120212122020100002102110000112002000101022120101112010010000112101221222211122022202201012210112221201001202202021201120212011101001122012214-
402212122201201012000100102010220211000010000112121012111200200220110222002112222112102012221121011120110001222112202010200021011112112101102200202114-
402200200220220221222121011221222201011002021001000002022101010101000210012010121022100202221022101102001112010222212122011110222021110121121100112124-
412201000100020202010101012111212000022211012211122112200021000201120111101002100202000110010102021020211012020201010211100122220122122020022200022214-
402210100110212110012112000121202100011222122201002201021010120102010212111010211201100200122201200102211200121000100022201212001011020212221212221204-
400001112001212210201120021221021121201002111122012020102110020001102110121122110000001220021210112100000102121112120110222210110212002110112112210104-
421212222011212112122201001211222110200210102102012121200110110111211221001221212020112010100021121210111111121211010122022202011200102210122211020224-
422210001200202002212021111110112121221112222000210211020021210202020100202012010200002201002002120002012010210202022012221201220021000111211221011104-
421100020011212210210100000121102120100102000000222220122210020212121210211020111211200000212022011010222112220122220011222022121021000201101020101024-
400110001222001122011101111220101111000211011211002021112202001210120222202001221222112201011011200201211121001201202021002102000220021222101111202124-
401202011102122121222002011111022100110022110012122101010010110001021020100220111211121110022102201000221022220221121212000011120211112120100120201104-
444444444444444444444444444444444444444444444444444444444444444444444444444444444444444444444444444444444444444444444444444444444444444444444444444444-
