444444444444444444444444444444444444444444444444444444444444444444444444444444444444444444444444444444444444444444444444444444444444444444444444444444-
420200222221221211001110201111112221111210202212022201121120200200022120001201210122002021220122001201110100001100111112021111021122101210210020201024-
420021110202202010021120200000112211100100020200010211021000110100101212101112021122011012011012022102001222212101121012010001111002220210122111120114-
400201110011220120100111121200110120202111101101202100210002020120121212222201022100002200020221100102011202201220212211012210122110012221220210012024-
421100220201100200200112221002110111110122010212122222121102201200112001022122001020122012122011110020212112000220021120111000010002201110221111112104-
400122012110122021122011011011110202110221020112111220211011222101210011221201122220100202112001001102110121112221101101110212101221002100111111001124-
400012111101101202221012101122121110201111120121020012010202201002000212021212020021201110210112002012010201222012100222201211110222000011102110111204-
411021211110022200000110121201012201220201120221020101222020212112020112000112002211212122121102001210121020011012001221110221111020202010201111020014-
402122010101211201111120202220100100100111011221122002121002102001022121102022111100200100000021112012220001022112011121101111111212002211021100202024-
401022000101202002212110102200201210110102110122020002022202211220201112222200001012220120122122220012002021100120111210020221000220121010221121210024-
410221112110201110012011212102200011121201210102012212012102211011222011221000120011110211100222012020111120010100122001101020200202011120011222122014-
420112101112202002202000110022021201222010002021200121121011120221102112210110210012210020100011211101121002012022111100001010222102100202002121011024-
420110221201122200010202202000100201201222200022200000001101012122221110121111202200212221122210200202102202221210020012221100222021120002110200012104-
422102011110122020201102112000121111102011222122002020001100102110111101222100012010212110221020100122122010211122101121120000100110011221101022212004-
422101222201020200201201200201201221200111022022001021201112110010122120021200201120111201212110110210000022012000121202102100222102201110002221002124-
420120020101102001110000012210011211201020200221012212120111202200102212120212112100012022011211102200100111102221111101112212022021222120222010200204-
412221212111020022002220122121221122220022101100001221021202121000211011110001102202010020210002220110022022222002222122100200212121101112211020020024-
410200010201100000100122002101020200220222002200120001212111002212221102010212220210121002101202121002022102102221121220220210121202011020000121201224-
412211011012020122010012101100200211022202120110222012002202220012200221122100111112222021220021111010222020000021011200100022021112212211102022012024-
422211122201100202111010100212201022011010221020001121021100121022101000000121110210211201211212222000222212220102211010110121221210012111010010010024-
421022110002011002222001110011200220121110102122211102121200101010222122010122012010221020220210111210220120211121110000100210122002002221211220020124-
420001112200011112110112121020100121120110020122002110221201101101222222010012102002010120000011011021101022220022102222020020111212022012220201011204-
421222200012200002110211111122201222120122201001112101111122121012102222012121221201222120011000120002010112100021011012120001012100212110100220121014-
410021222212021201022112210011120202211022211012001122221100021121002002222102022122112202102112121022221120101002012221002111021220001020211012110114-
401121212211211012111120011200121112202102201200221010000011012201122121102112210210211211020021102110122000021120022220102222202110001222022120002114-
412222210000102002120022211222000022100200021222102100202220020001022110112101120002210202112200211201001122111211001120100221200021102202010221201224-
400000102012000211000001221220110211011201110211011221021100101111000102100120200100212202002222110122222220012001220022010002122202002210022002212024-
411120012201102121102222222200120100211011220120210000000110121011111110101022011012011222212120020011102122122201110122001000202200011201212120121014-
410011202012201022212020201020121102110210010120211002002101012010201222121022101001201121112121102110210110102011000002012221111122221001111210010124-
402220101201120200100222000121020220121210020022022122101111010210102122010121021202220120110012010210201211021120021122110022000221102222112122000214-
421011201120010200122210220021022221122221111101101211110012201020221102002212221120102012010021112011202111001010001122000002102102222012202111002204-
421112202221222010010121221112020011012122211111101000200001020111020201012111200200102012021012222102210120010120000112012111121202000021102011010024-
411001112001202200012122002100110010021111022111220021211102201111000000021110012111002011111200000201220021021100020221202010101110201110021120222104-
410010000102020211122111102120102122220112001000220111011100021212122002110000202111101200012102002211210020120121211210222021002221102120221210100204-
400120022120100212221011122100012202001010212210020021112022000211211211022122201010202120110102020121120120001101001221021102020120002122202120100214-
421000122220000021210202122210100221122012000101220022002012112011101221001012111100220002111202110211020000111122100211102020122012202121002100200024-
402221212222202122001100121212111220012100002022022001122200022011102122010201222010120001112101211012022210102121222222221001010002122112121020212204-
400021120200002222122222020012022111212001010211000022110012010022111020110220102212222220210020222121212012201000111120022012202112011121020010120024-
412020000120101212201210202001020212100220221002211110122010102120001222022000002221212201212212110221200002110121120020000012002120021100022101100224-
410021100220000122212222110221102102010112021020012001211210201222111112020120112000102212002120011020000010212202020002220200000122121120101000020214-
401212112121101222121002200111011122011111200121011202021210020111210222102011100101201212102202102101110102211122020022100202200102020021022000212104-
410002000022012011001002000002221010002212211020020211120221200121211002212112211201222110100212100000210102121212212000201100001202212221020110201004-
410010222110002001100111121122121011212122102122002111112200010202001212101012202120020001221100012100201111021011000012112101121202221120222112211024-
411212201002201201120200222001021221112121121002020020210120112010102211210021021001020221112201220001021111001110101012010212012122212202121201120004-
420110221101112100120221212010022102101222010021110121021002122222002000022000201020011202011022200010012010000022201020001121000002201221100222020114-
420112000002210112022020001012220020222110101001120012112201212100200122211222220021122200010011012211222201122000111100100102111110211112210120001204-
400102000120202000111122112021122111100210212002011220120220212101120211211002211022222101020220210012102102000122121110200222000020001200221100111124-
400220210120010000100001122021200020102211120122122121022220201112220102100121212122112020220210022210000122112212122022122220200222220111002221211214-
411201212110100222001111120100210022102212120100202010202110110221012121211111101010022100000022120010012201112022012001001012111102212112220100210014-
444444444444444444444444444444444444444444444444444444444444444444444444444444444444444444444444444444444444444444444444444444444444444444444444444444-
