444444444444444444444444444444444444444444444444444444444444444444444444444444444444444444444444444444444444444444444444444444444444444444444444444444-
411101121222112012011001001011022222212010021022222110201122201120000211222002111112122212220220221101212120100201002102201202000202012122210102112004-
421212110022111120202200122112201120201202012201121202221122200021211002120102101000210010010101102020000021010221212010001021200002021211212220101204-
412012012100202021010211211212122120022212101002001200011101200212020010101102011212021210011012102200010011222002100202022100110112022201111022112104-
402120122110101001100111222120111112201122210111111211102120021120012000201020201000202200111120100002021020111212220221012100012010121010122110222224-
411001222012200110200202002122010000010121201210022012102111202221102210002102220221012201101121222202022120222102002022120211122222111112200120020114-
421201121111222200110010110102221112102012100220001210021121021002201122222212210120121021002201000201001010222220221212002011211100222100022011220114-
420010002122212210120222020021210202010121020222000122021000112121000212010102120000222211000101001010111000000220220001011001120101022221001001202104-
420010121121222200012122220212121202201221122110220100001022220101000102210010022010210112101200101102011220011020022110011012110121211202110112211224-
410101022021221122120000102212112220001201221220212112021122112011220101200222010111210022001001111202112201212120222122021122122000200120200111010104-
410202022220020000222000121200101221021101011210012222012001002110211201100212102022102012200021121022201222010210010001220222221210010112012212210004-
401100020022100110222111001020022202201202212012101202001111101111110120211102122112121221121022200001220120121102112001222211020110101220020012110104-
400012111122021222020212000221121020212012221012210100011001210222001012011201120121200212021002021021001202012222212202220201201101101110020012010214-
400021121021222121021212121201111002020212022101001010021011120102100102120110011020221122210022101212012001202122121110112011021001221122102110001114-
401001011200000121210121111020102102122222010012221221122010201220222102101010121012100022111101121111222212220112202012121121200012010022210100120004-
401100220010111202012121200200121021102020112022112111000112121210220010110201110000221001222202102021202201002201210011201112110210110122220222011024-
402110122201111122211022220211001201221101002112122002100000011100120200112210202211100112122021221102101100000122201110112200110001002021012220120214-
412212011110010000010111011020202200100111212001212010010122110112211021111100110111200212221101001020201200200012011110122021120012010012001002221114-
400221000222012001110120021212210021012220222001112211121201122002121102211111120100010122000102101210101121011012021100220202102102121110212222212004-
401210021011100021110001221212001110002122010020010120101210212121112220011101022001100120101211120220011220022212202112200112000010211220211001210224-
400010111200011221022000111222211100222211001022000200021020111101012020102112212212111000221222210002002101012021120011110101122012122202111002120004-
410001012221121110112200210102112222101021202212211201111101102020211200010101010011201210100101101122121020102011210220100111220100110102010021022224-
411111001201012220112002022022100211210112010100120010001010200022201211212210011222112021012022112011120022202220021211011122020002222120210000000204-
410101122210210122012221011020222121022110200122112121110222202101022200100120200220211111110121120112111112012020012212210001000020002112110202212004-
412202212011011211122110121121221121100201211212222211112220110001222000012012121221022121020012110212021111210120122201020000010011101112010111222004-
401021122121202112222202000211212000101120122102200121001220120102200111121121122211112020102210201001120220102202022200220010021200122011010122002204-
412021112121112101210120222212101102021111022002002102110212010112221111012210012121211022020012101011022111122102110220001000010111122212202021201014-
422222101120010110222022000021001222211101110112221112010012010212122200102000101201221002011202121121002020000101002200122111020210002222111122021014-
420020102122110102021222212211020202020001120112021120011201220120212002022022200101221122220011202001012001022000021022220022022111110121011121211224-
402012202012002100100112001112002101101022221012102001220002001211121211010221110111010120210012100101100022101110122011000012022201002011102221101004-
400000022100110012110020000200201111010012001012010011211112001000011122100020012200120210021001211022122220101212100122222112212201101201121102201204-
422012212201111022220101222210022022021100001120002202212012212012012021221112110122010011122012010120111012200121222002211021021102022021110011021024-
420010002000121212011021222102120201222202002110011122100022221100212002110210011001200100010102210120010121210101020120220111221111120002100002212214-
421220002012210102021122010022122220122210012101211001122201221220102211020221100010220002112101111222220110120121101201102221120020012012121210021104-
400112122202200221011002121121210212210022110201120110101212021110120222000211222111200110012100012212211002100122220212220202221000000122101111010004-
401111102120111021101211022120120222022121212101201111021010101222021122000220011102011012022011100120110222002002111202200002021011110121020200011024-
421012021120211121101121221221221000200112022200112120122002010200211101111100100012102202120222210100010022210010011221111122221100200111201211211114-
412000002001201012012002202012102110111021212111121222201200202220120212022010201102101120022022220212001000101112220210121222200120202011002021201024-
410201020202111000202010021112121211222220111100212012002010100200022020021001222102010210100112101011110001112112211212202120222210020112022012220124-
401200202110002020122011021112212000112112010212112222122220222121011000002122110120200121220021222122220220220102011101002011122012010020201101221224-
400202200222201002221012201000102221220011012211110020100120202202022102012010000221022222201110010200222011120002120000011220201001102211002111211014-
420111111121202110202012220201122121022221200001001110022120100022010211120001010111102112111200101012220000112201201102100221201120100112110011020104-
412200212101201101221202122112221102121201022202021020222201022212222211210120110111002220222212222012102120010110202110110101200201221222210202222014-
420122022121120202002112102010200121112110002022020121120112102201200200022000102220102100211101110102101022101200120002012011020201100101222101200104-
412011112010100101211120101000111201211211010101000002222222020001222201100111222000211002002010011200101012201202102101201121100012101211210120212204-
400012022010020011110122010022002120020201200010202121002011122110220122111011222001000210122122022112122000210020112101000112212211110011102210002114-
421220201001212220101010221121200100210001220020022020110120101122020021001102112212120212111210112111020122010011100021110210110122022020122210111204-
420100200100010022222201022210222221221212220011020222010022020002001110110110020021201000110122211121221001211101200000210211120201102201001102212224-
421112002220011011120222121120002101002202211200202211001021011001002020120002102012120201011001021020001021112020011121201102200010220210102201121224-
444444444444444444444444444444444444444444444444444444444444444444444444444444444444444444444444444444444444444444444444444444444444444444444444444444-
