444444444444444444444444444444444444444444444444444444444444444444444444444444444444444444444444444444444444444444444444444444444444444444444444444444-
410021011022000102100212122221001112201101121020111011121100100212221022212120200111000120211021020121112212211000100110022122110012121112120200012114-
402220011021201102010120201120221020200110022001112220010212120121200021211021222100111100222000212112011102002211121001011101012121002221210020202014-
402022122202111120100020211222101022201022220020002100000020100011220212010002102022022012201101000220002011011100121200200110212101122012120212111014-
402202221222202001200020202222120221211111012221011011112122111020010210110202002110222221111010000020001210212100020121201102022010000212011010000124-
422022020010021220222011122202100121000100201111210122100000200210012001111101002120021120200000210102120022000211010002200120002101212121021111122124-
422010210110002110020012022210110120110201100220020210001121002011101022211121202200021100001101202020001200010202012122201100121002121101120020111024-
412012111001112012110020112102202211211212101102201001000210111001100021000011211011021000002221002210000010112102012220202022101222210112202111210014-
420001201102211010102210202210120222021000112212120002112100220010012212101011112100110010220011222100011021201121121101011200222111020101102001012004-
412201001210102202020222002000011021101102102120212000122000002010210000100011112200010202002121122201221212000211201010110020112201201210222022001124-
410121012111211020020000200211021211002110222001202212102200000122110200101010122100001101102101021211100222022202101100220111102100001212122000112214-
422001001200202102011211120110211020210122122100012001212111112120211012212101202112102221121120020202102221220010002021101210220011001001021201221114-
400202110100102012102002122120111011222121020212002010212121000100100120212102022220011200120011222012120112201220110200202211212001112110000011100114-
422220001020202022102121000201111222201210200100222222121210100022022001011002121020112000000101001011211121221211011000201100121200101020001202112214-
420011002120110111100012100000101121102010211022202200002101220002212110122100202221111110022111121121120201210020202011222121211011122110011122102024-
411022202102212201000110220022020000122110002200211110112212021001201002202220211110002022012012222022111101101101002212111101220112121201000121011104-
411200122222102122101102201110220022021200112100221110202220212122222201220222220012222120100102222002100112100020201120120010021001100220101021200224-
412010210102100020102122220110201002211000220121002011111002201221201221101000020220111010210101022110002102000201010020020212211221221211121110012024-
401000202220121100210122200001002102002211020100002022022101222201100121000221022111121010122220201210010221210100022220010211212100111001122010112224-
420201012112110022111100220102011200002211100012121200122200221020220220201011112101020010210002002020221220101011121100010120220121120002101122112004-
412212101012012012222120100001120100001121002010110220001110111212120121020212102210102222122101212111210111121100222201121002222101100022100221221124-
400001202001220101122112000200200221100221020001202001112212202021211010212120201211202120121102210220021100210120102201202120112020002100212012011124-
400120011000212221112012012010010121200200100120222001101212010221012112000020200102112020101102112222021111112220211001122110000010112001101020012214-
411020001112011002202102100122222201222200012111200011111210022012022112222101200211001020120020011021010021212112111201200122001001222112021122120024-
412001100112011221010112012122211201000222010020021110021201120022222210210111111022221021221101011011020002010120120022002021212022121022101220122214-
420012002002001112201220022122022202212022211121222102122010002211120012000022102012212021002022101212202010010110002221021102202021202001000100121024-
422122021120011011012112200111020020112222001220001220112120211220121101010202221001002211121212121200212011202022102101001000111010221200000011100214-
412222020211201010201220002111010011221021202211002022100222010201021221212101201111102221221121211222111001022202021010022121022000122020202010201024-
412011102020101021110021122221111221100020002110000102222001020111011021112020020110002111110210220202102121021111022220101020221222020110211000000004-
402200112020110102102201121210222101102121012012122210200000202120102202111210011010112112100021102102211012002221002100112021112201201022211011212104-
411002120001021110120201011122222111022220012121001000212001122202211001102100200201021120202202112111100012100222102212222221021021211212211110110224-
421120102012102201100110002022222000021102121201000121110200022202102101021210221212010000200201011202020121221221101021022221011121101212011120021224-
421002022101211001002202002100011200222001200010222210021010120110220220022222002210210202122111111001222112102220100001202110111220100122022212211214-
411010102020211022200112000210111022212122101212000110120200202222112011002021021122202120001101022211012102020222201102220121000002211210120221201014-
401001222200101011200112212002022222211101220022102002122221020120212101001220000211112111012010200110121200210212101100001122000220200022210210011104-
400000211122120220110022122010012111120111201102020021212201002100022222101101202210100022022212112201120120211022211220011021120212120002120121220214-
421102010011022101011102122011220001212222100121020201111111011021021101111000012200020012021002002120022110001200110101102222120010202200001200222004-
411012110110002001011102100012012022110022221220121100102212222001000111220202221012110222221021212211222122110202111201222010111101102000201210210014-
412022112201112200201121211011121010220000012122011021002001221011112210222121012110002112100012101212201222022121222010121211102012110200101100002124-
402121100100212210200212100120120000110201202220020002022222121110111212000000121110121110110021002210012112221210222011020102010221012210001110100214-
411111101211120102202122120202100221210112201221220102201111111012212011011000220212011210110022012211121020220021011010010121000100112211211000122124-
402202112100022221210002022221110122212011212112201102201221111212012102001111000020120200001200111000021202022022202000012222101111120210101202010104-
411222200022201101201001112120210101120021122120020222202020100021221200202202102112010010121001201110200121020012220010101221010222001000001220221004-
402011001201112122101011110110021100120201011022120102022211020022220001102210222000120100001010002210020120200201220101210121222221210011211211002004-
421020211111220212011201011201010200101211110221102202012022101220012000122110000000210020110112121012120202011011002211111112111100122000120022200104-
412011202002222100100001210102222111000222121020122201122212220221100020101001221222021120002101011121111121012222122210012020010011201111101201002214-
410022122112111121111122022120001110020200120210122122221102212001002122211210220200102100202011121200210120210102000220100102220021200121212200120114-
400002120200200120121100211200101121000222101102011001210021210220010021001012200120000110021221102110202012100021211021012112122101221102221122101024-
410000111212111110101112200020010022122111001112020122110111202200211220110011221210200112121020220002000200122120122012110102221111012210222002200204-
444444444444444444444444444444444444444444444444444444444444444444444444444444444444444444444444444444444444444444444444444444444444444444444444444444-
