444444444444444444444444444444444444444444444444444444444444444444444444444444444444444444444444444444444444444444444444444444444444444444444444444444-
412002121002201102121211220220020112121020110212120001001221212122222211011220100011222020022102001120122012101110120122010110121122110202222210022124-
410121111000011001100222102210110210022022021221102210200001011122011001201122222222122202102121220120211122201200222012102112211102200011100011211204-
400021100220022111201220110020120212120211020111200202120200100112202110011122222102202111002201211202020002010121000012022222021110001220212010120104-
420221222122102120212001000010211102212201221012100212011201102222101020000022212210021222202111021121001210121112101121100021020121000201120202011104-
420112122021100120120211111100021110121210110111122002001121000110211011202021222201001201012111211002010122011210220122202201001020120102200200121204-
420121210001102112011200011202010212002220211210011002122012122201212201111221112221000200202000021112221122002221110121201221120020201021120202020004-
401002222022020000200010101210102111212010111221012222122002010100010220200002020001002020021122001221201121100111010222012100120102102120002122101024-
410000220120112212202021020100122010102120120210212001100012110210200220002002000200002000122021222022102020002110122211021100111020212011020112022214-
410010200010210122221001112020110100210020002001022111011010220012120102002212221002002200020100001121211002012000100111001022002221020110112120110114-
402122012001200121221200022110210022200102000010220221102112000102012011012221220112022101012201212120010112021002101212000011211000211111222121111204-
402110202012011111011120000122211211021022100122201201100122100001100020011011021212102101002211001212210010002021210010101021200001100112220120222114-
412011012010201220212210112212201222002201012020002012110112012000010202222202212222111202121212200010210222101000100111202210002022002221022222002204-
421002210212001100220102002102121011122111221122202211220011022010212100122022101222002202120201111212002221220121122210211120000021110012210101101224-
422210012022001200202211200211212201110122222022202021210212002022022210001111121110021000222012220020120221202012012221121112222200120000010110201014-
412121212220020101212020101100221112222011121202121112020212120010112122201200100100221001010200202201120011021002001102120220122200022100201211111124-
400011021121212002200221022100012022112202122022020020010200111010210121112200120101110122111021021120200221022000000200112021001221111212011110121124-
410000001120220011000001111102011011112101002222010101221202222202210121021012212221110121121212221100012201221102120222012112101201001201111110000224-
421112011121020111211211211011112202011121211002122112020122022010011001002020010222112012202012111121102000022000100122112011100102220022000212020224-
400200210101000210120012200212102110220211011222100102121011120121002202010000222011210221102100210102100110202202201201112102111111000101101011111224-
412222110202102102010010110022210012101222020110101221000011021220022212001200012112122012211020021112010221122020212111210112201222102120201202010124-
412221011001102120112122220211111112022122210211110010210120200101220210111022001101122112222211001200120111122110101102100000201012201210222101210124-
422211210120100011001220220210012200101112200020100200012021112022001011212112101220202022111211200012201022220220021020122211122201102122102111100124-
421012021012221022102121100102121222112222102221120012111201011202102202022221011220010002012120220212001202112122021201212121121100102022010012020214-
401022022022212121221111102222101100102020212001212002110101102021010011121222202122001010101011002001112020002210020002100000220111011011211012200124-
412102220100211112212110122122211022121211100220001012022120121101221210111022101211211202010110012201120010122222212221112110211100110111211212000024-
401012012221100001020221101111200221201021110122111012210201100110000002100022210002121002002102111120100101110012001211012122112002000000200210111024-
412010010021122001122122210002201121000111021220021222210010020212100212210020100102021021021101020201001111102222002010201010002012211002001110100004-
412112100200201022100201012112012202010011202110110200210122012111200001202211112222101010121210211011102222222220202220201102020122220001122110202104-
411000022020221202022011221222011010000022120221102102011100200121202101211012021111000101100200221202211211201011011222201222012222120011220011010204-
401220021220211121100211212222211212201122101012102120120002220111012100211121111102022210100110001002110222221111200121211121201012222010211210101224-
421121011022202020120110011111001112211101121021010211200122011000221212120200221021201111012110211002221221011221112110002220112210210111200210101224-
420022021101100222222110010100101011211002121200121020202020102201011002001020122021012011100011020220002102101112211211001210001101220022110020121104-
402012000002102112012110121200102212102010011010222022111022212222220221200002022100222202001221211101201012021100100211110001220021110210221202012214-
401212121220212010120110120112210202102110222220002220202222020202210001200001002122012111112011212002102202110221100202102101201112102012001212012104-
401110021021020201022102122100202012110200011202120102011110011002211020021010101212002110212220020010211200202110211111020200200202220000002202011124-
420121111212222022222111122102010200012211001122020211120110120020201000101011002021011011011022020220220100111012120101000100102101221121112122011014-
400111112200210012212101002202210111221002220112021112210211200010210212200211122221212101211122011212020002012222201202210210010120121121120121121104-
421210011110211022001011121101001201121220011100010220121020101012122020210011211121100011002012012112121210201220120222101000200200122212120022202024-
412010122101111121011221111201111201001120222110122112212021200011020201122202200222211101200202112202011022112201100110100102000010022112200221221114-
411201010220010001100020021021202212200222211220212210221220011011121110112101221002221220022121210101212020222001101001210111112112002222220001020104-
412102220222101001120012221000020221110121000121010112010010001211000022120112102011121012200200110020101102102110202102121001210200002000122200012114-
402212101212011112212002200120110222021011220222002212000110202201110012110201222210201201211202211110001221202112222020211000020021202212110200200224-
411120001102211010101222221001020210101121121000010001212211122011211222210000200100210221011212012020102121211201001011201222112222122200112001121114-
420200002212011101021221000102102112100000020011102222012000221222110110200101202101201000100211101122110011002011202000201211212111212102201122021224-
400211120200000022101020100110122101210020100110111210222102112020021020222102202000000121010010101010211111012000020120012220222020201021210220102004-
420001112120212120221202200201110021021120220002020211100020022020212001122102211202112021101211101122221212102220121202211120100222001001211001101104-
421220112022212020000111220102122100010002220200202102112120011000221021122221112020100102020022212020202111100210020011112220002120121012100102001014-
402011202112122221200021010000101111012100210220020012000112210111110121011222020121221201110121210120202120112211122020210200122121010121101001222104-
444444444444444444444444444444444444444444444444444444444444444444444444444444444444444444444444444444444444444444444444444444444444444444444444444444-
