444444444444444444444444444444444444444444444444444444444444444444444444444444444444444444444444444444444444444444444444444444444444444444444444444444-
422120000220120100022202010202100200211121100011021110011011100002221201020100110002222211121100220101001020120210212111200012200102121200000220221024-
410100121121122211121001212022202020220201101121120002011102001022020002112011100020001202102102122122121100212222022100210022120100021000012011022104-
422220210200101012101101010201101020200002021221221022122000202212002000001011121020122210022112002101012200001220012212011222200121120222002112121014-
421221222200022011212010110121011110222221220202000201002001012021022222202002201122121120102101020122001101222120002010120221212220202000202020000204-
411212201210220000122122010221200010220220022110011211200001121112001011022000101112112221010201222202020200210222000221002222110211000002122001122224-
411000200202012012022210200122221001202222010001020021022100021112201220022012211010102120111120212022012221200002000100212200001222011120012010001104-
421110001222220020200121102211100211000101201022110001001002210202210211120202102220021022202111200021210220211000110201011201101201212010201122020024-
411221211011021010111101201100210022112020221002220120022102100201201211200201112021021100220121112110112210200121221001002120102101020211012200221224-
401010200001212101221000112020112222210222102010202221002120210102012100210222000221200001102120121200222002101000121122212022211021002211122212002004-
420120102122212110002001121021120012000222211002121122212002010222000122020010102221201222200120111220220002202001111100022101000002002100021021121224-
400100202012102122012021202110021010020102100222112211201120221100122120000022001221000012022220222022101201222221021222212212010022101202022120221024-
401211202000222110210002220202112020002120122210001110102212010012011100220220020000201000011010020212211022200120200221222112200101021211011222110014-
400112022012111211000220202112112201021120012100021110010121121002210010002120102020012012111100000211111212211021121201010111222002001221100212220204-
401221212101102112012002122122110121211121222110022010221001200110021010011100210002102200022021002212212222121122221022111122102102220211110100221014-
421110122211122222000020100120100011102022020221210002121011022000102022110202011012212112020200112010001002000112101102210100001210220102201112001204-
411220120101122002102110022001212101211000122122222121002111011202201210120221001112210200100122022110220201220200202000110102102211200212012201100114-
400010000020110221222212202002221122122002211212221002221122222111022202002111201221100100021002020200012100210221211101210021112022011202000102120004-
412221010211111111001002011021121212112212112211211201211102002222021110202102020100100221100020211002001212201122220100212202210120100010120201200104-
410210211202222101002112001000021122001001011220110200011120001122112000212010110202011020101201000201001202020000010222111011122110110102201200211224-
401021111101011002010112221220021012221022011201011011102111022221121000010022220220220201121112102110111112200002211010111002012112121111121221121014-
400100100101000222200012020112022220211102220211020102210012102002020110021111221200000220012222122020001111201001210112212020110102222022120020221014-
422111120020220122102122111102212100122201020121111001211221112101120202012220121111222111000011111101222211220010121122201202121020011210002201201104-
420210222110102111102120101222010011002221100012021002212112222120020100210011122121202021212202021201000211010021111100111022122111202010120202222224-
412021112011222111102220211220011101110120022212011202111001201110021220100220110220002110210201012112102210100010100210002102102201000210000212011224-
420001120110120020010111211012220021000221222200000020122200100022210211222211112202101121212000211010002101122211111100210122221122011000200020120224-
400112001220121211021000212211220002011121201102110222010220000021021200101111011120210202222000121111201000201021220220202020211212021001202000122224-
412122122022221011001000012010122220111212010112100122200200200100022000002220012002221101020220211021022010010101112101101000202121000001102011220114-
401011012021121222200200202200112221112012122222101022211101111012221002120111102221120001201200221202120202112011222001121102010100211222212120210104-
401010212102101000022021222122212021010111002100112222012001010222010212221011022222101212221212102101122012100100110202100100010120110121000022111114-
410022020112200010102110121111110221220000220002121202211200112222110112011222111022221101200012010000012111200112100100101012202221020112121200212104-
401120121111011120212200200022110110201011020220102221200221111021110201202112011212002100201211220121121211021222012102012110120122021120021210202024-
401002101010012001002220211010021102020100020202000121102201112121200220201212201110002000221210210201100101102201100021021121011200001020122012001204-
422121222111210210022221020101122111210221020002210111012022000022121200012111000001001000010201100220100210002100222010001122111220012000102201000014-
421110020012212200022212020212222211112101111001220212101120011022212001102101002201002222012000100221112011212112201002000212022112111120201212122204-
422021102220101220102012221201112010020221212010212220222101202122012012000012012122222101112000212022201002101011020000200022211122022210102100202214-
402110120020101200110022202102121012110222102020122022002111120001111021211200221011212211122120120120001100112220002212211211102112112212201002120114-
401121211112222201211001012220121020112021020102210122001000110012202021211101201211122100022010102010211221222200101200000022020121022102000110221124-
400221121112110122211012211202111200111211102011010211000220121112121101112122202110222010012210212212011020100221221001012100000210002101210102011114-
400211221122122102111122012011020111102021012002121201101011012020222011022111212102010220020212112202101101011202001111110110002011101020212011021214-
420021120211000112101210122122222201112002210210200011220000120201012222010201100111100201022012120111121111020122000210101002100221222100201101110104-
400001002211001210210000022011112111012210010221202121201221000110200200222101020220011222110000002111202121120220021111211021112100011001122002112214-
401122111202201101120021022002011102100022011012111002010221102011121010110122122211012010121121202020210221002001000211100101202002112011221120001104-
421022120101112002222102100111010022121021101122011001000000012220122022012012020200200122101011201200120200200102000121220010102011201200120120221214-
402220200101112222021010112010202212001112110111022212220212120222000221121111222200112102101022021001120020100210102101111000121211021010222102020104-
411122121011022000111121220110011220102010112012022010001211102102010102102122122220111121002100122102211110021212220200221112120200210222210100202104-
400111201101010010122012110021221112201201001012102212122110200201211011111022120000111100101202201202021010002221011200102121022212202021020110011214-
401112201202000112202222102100111102121201211202112110021211210011201112020101212002112210222101212221000000110200021100020002101100121221002100110024-
410100011011022111212201002011201020022211001221001210102101220220212110100012011002111122120101002012211121200210200120000002021011111222222201210204-
444444444444444444444444444444444444444444444444444444444444444444444444444444444444444444444444444444444444444444444444444444444444444444444444444444-
