444444444444444444444444444444444444444444444444444444444444444444444444444444444444444444444444444444444444444444444444444444444444444444444444444444-
411201011020022011111212211210000212011220001202001012111021221121021120011012122010200220002221200202011002122111222211201120121000222002202110210014-
412102210211011021102121000221112020022110122210202211011202212002112111200222212102222122122202120210202010110201101211010021012212202111211100220104-
402112120011100001222000001221020221210201000022210012010200200212121100111111100200212200012011000210002021001102200102211101122012001201202110121224-
420000222121201212011110022121200122220212202200110201100021201201111201022222001010221221022200000201020022022201012221000100020212111211222022020104-
411012220120111201112102211220211221000210010021001001021010102022122021200112002011212112020000222121011120222200000112212122012011120022022210101224-
422101221100201120210220110201200220111202121000000000202220102201010011201002020022211201102122020121100122220102200120120221121000122211201100001024-
422221210121102002002222010022210100101212101100201100021210102120010010112111202220021001110122211000022021001122210202000110020011210000111010011204-
421211222112011012102201001211101011010022112102101122012102012022002111122201201120022221201210022122122120100122120221222111101120011122012012102124-
412022020200000121211222001001001211221201111110201110011220101111222121101000222121121221212122221112112210010220222102102121000011010122021011010004-
401010112121002110000221222102111020222011112011220010111010002122100221112000121012201221101000000211022020000001111001022221021220212220111120200204-
410211111121221000120111010222220100121122220111212001220101012202122210010112102102002200220210012102010120012001001021110200101021100201100121222114-
410001102210200022021200200010121022002222022020222222101201122201212100001110021022020110202111012222212000210111110111122111212112101101121010200004-
402022120002121020202201011222022102211222212201110122110021221201021020021000122200021221220110020102001112222121000002202100101111122210112000110214-
421201220222221101000212002110101111020121200200112220022100212120021202010220200020222001102012011101222210200012100121200201011212000110122020000124-
401000101112020011212002012110210122222021011022020200111012212200200212210211102100212112222122022101211220211111020102002000012122100110211102000104-
411100121110122212021100201011122101000202012200202011211101000100001102122201102001102122000111100002120011112210021101101202010122000212110222011224-
400011220211100222210000011222121212002022102002120011122211010112100200112001011002221000211221202101102002102011010002120112010201202221212220112204-
402221011200100220000210012112002211001112201222122000210000220220110220111100001110000012000122111011120022001111201201111210220222012020122120201024-
411011022021102110220212001110100220120010202102020012022122111110221221121210020012100212210211000022202020120120200121110100121010011020210020210104-
400110022101221122100202022010011222221200002022212000121200111002122122122011111101020112010022221110211021010200211002111210201001120021001222002004-
421121120102120111212210200021202121210122210122001210210120000220211112210012021020202210201122010112201201011011012211220012210010222101102021120104-
411110002012010010222102202201121010100110022001210212220222001202220211010101111222111012222101202020122101010211021001212222012202111000222220020014-
421220200011211211010201221100200210100001222012210220020021020122011122022212012010102100220002210110201200000112020010011202221111102201221212210224-
420210011022220020222100221201120020022220000201122102111211100211110011202020120012210122210111012201212221202020120220100000201100212002012121002014-
402212111101102122010222011212200221000202002212121110210222122102101021011220220120100012012202111112110020011220122222202212221010011120021210110014-
420222220121011200022222212001022221110211021202021200101110201121022211102010100021000212221110011212201210021111001100220210122212121112012000101124-
410201112020111111000000202211020122020222121011021022010220011010210000202201222202020021111222010020222001120112210220222011220212002112020022220114-
420011022102011100220121210211102210112021220002101202001000002110010211020020010021200222002000211111201021001211001201110121210012211202002211001224-
412020011122220121102122212011212210010022120022222102102121220201200210000101200100021221222201111002202010200101102202202010200212121012212120110014-
410000202221012212221220202120220111100221201120210210110000121010112211010012111100102212000220101100021121002100211222102222222110220122000222201124-
400112020212022102022212100221210211100120121110101000122011020120002002101212121000222210112201212122222001200201120211012020211200011111101012012024-
410002210002201002100121111001101101202200212211002020111010021221112110212000012020121012112112001002022221010222101020122122110120101211102121111004-
402110020002112001011121102001001221112001222010002122221112011011121022222210112120202022220001120102010210021010220210200100201102202211000002220024-
402122202011202110200210122010212121001012200212002222111001212011010121210200200020201210201000111210200112022111200121122011021100012021020100201214-
412200212220100022020000100011011211202021200121112000001022222022122112220102220121201012011200001122102020122022100112121212022001202001100011222114-
421201120110001001121012100021001020202201000210100010012102012000102120021201022021001020112122220010220111012020112210201201011021100222110000210224-
402101011200020121010012202120222201101010212200000222111212010002222100111112101010102021000000021100110021012012201211120202122121000212022101122024-
400222021022200002110212012220121010021211021110210022000010211211122012001102212211221001112112111112011011201000000201102111021211221021121122010224-
421101110101022001202120120020112010122122222200021010221012201011121111012000000010222200221212021120222102201101121100102101121100021200120102121004-
421120012211111010111000212102002110002000200211002111111122100211122122121000001020012002210020010211111000101222221111022121211212010010100102121214-
422120022111200100021022002210120211210101000121211101102010200120022002210112202000010100121100111010011011001102200201111121122202112221102211111114-
410100111010201120101220010021212120012011110022220121212121012102211121202022100112101122122010002012202212100000022202011000121220002121022100200024-
402022201010120102000200210120202122110201100010021020210200121121201201211202111020122011002102100211200002001120120010020000200200210222212011002014-
401012121102200002012210022120001222002202101021001220010221001201220112200001212020212010112100121122100120212102221010021120002121020121010200212124-
421020012111021110021102100010102112101100112212220022000020110000122110220012221220002000112110102211221121221022112011020121000002220010211220022204-
402111202201220200111002102020111222020012112120212221112101221121011122222012121111102002221010001120002022010222202002001210201012110200220200212224-
412110220210210011121110211000020001011111112222100110012010121122220100020212010001012001212001112000101101222200002222110020121201001211111012000224-
421211101200112021102010201210021112122211102111021211201110020121121021011121111000021210200121211012221220212020010122212211101201211122222221021014-
444444444444444444444444444444444444444444444444444444444444444444444444444444444444444444444444444444444444444444444444444444444444444444444444444444-
