444444444444444444444444444444444444444444444444444444444444444444444444444444444444444444444444444444444444444444444444444444444444444444444444444444-
422021202012221011102200111120101211120001122222012222022101021102002221112200020110110111011121211221020122011010111222000222212220022011011200111114-
420200010021001001001000212220122212221122200102212201110220122022212020000120211111102010201200211111221102222012000120202210222220220120220211002204-
410121100221120221200002102010022221210021020102220120111112201001210102201002212010110212011001101102021020011011001120120120120102121200020220021114-
400220112200220112101220101222111220110010002221102112122001011212121102011212002121012020221211210212022010220012120112112020010100012001012000111204-
400221210001200020011000000022200000102122100220202212111100101012000211201212220102210112220201202121211011102010200221222101220212011012101221011014-
400122222110201012210202201202020001120121001020210222212000002012022221220021201211202211011010111020122122201112101212211112221001010212200221121114-
420222201102020102022102012201220111110210210212112121202212122201210122212220012001021121012012020200220110211111222201100110110202200200120122102224-
412000110212021000000121201000211202210001212210120222101121102111201112012201100220202202110002220210211202021200021021110100002201012121111011112024-
401120102012021110122220121021121001010222211120111120201121122001201010101222212111120022210002012222102221221011001121122111010110212020001122002014-
422021020200121012010020010200121110111221211000220201011002100100002212020001210010122200200000201112221101221202001211001110202121122210210212220004-
401100020100101002012011212122100200200110000011210112121121221002102110000210111111012211111202101120112212201001001221110021221102122221111102102014-
411122112110222220121002112211010121010010222210121020021110211111001020121102010011122111110210121021120002000222100000210212122002101012120000222014-
401110221011211202121012112102202202110001011012102210220010210012211112100100201211022120222211012111120010220122020112012021002111112022021100010014-
410022122110222201020212010000222222021121200000200221012121100222010112200021111010012200002202112211100222200010202201002112020200112201001201000204-
422212010211022211122122000022010220121022222012222211101011000110201020010010211200122201001202212202220020110002021211020221100101102001021202221214-
402211120201221212112202100101202222221122210222012120112121110221022122111212202212211210112011202221002201112110201110000121011120021202220201100014-
411021220002210111222201201012111010020110022121021021000121022210212020020112000110200201121112122210102121020210112111211101020200022202220221011224-
400000122111121000012002100112200012011222220122002111211120122022001100121021000021022001001100111110121000200000212101011001200121211121220021122014-
422011110210012221020221022021112222222112220022022002011012001001020022211202120102122112120111221021200221101102201021211000002122002012010111200004-
422220002102101111220212110011102100121012101010222220010100211110211110201100120211100211011001020001101222112202002020002002022110102121012020000204-
400210121112212010012111220012001011010212012001012101101110002111020212121201020101101001011201021212211201201011011111222221122012001122002001222214-
400010112020201210210120101011122212120221020112012020200020000100001100220000120000221010120102201100021020101010210200122110022101221010000010002204-
401200210202012221010022120211221100011112222001101111212111221011200011112111121112112222210112100200211210021210220000210200200110200012210010120114-
412221011020002012220120200210120100022002022112001121112020020012120200002000210100000201001120120221200121001120002111122202012010200220010020010024-
402210010121111112210112022201110100122021102002112110221221201201112121020111011210012020001022000001200221221010222022210012121210111220121022111224-
422021112222010111211011002200110120110021020110121011011020000012010112201111002001220000122212202101011201120210102001201102101101001212202010120114-
421200200002001221001011022100120220122112110120102100022102111102201100111000221100120120100201001111121202220120101212201121220020012021202112121204-
422010001202202021022201010010110110102121012220201120010110202102212222101201121100101212001101221022211001011112221220201010100000100002021122022024-
402200211012211100020101122110122221020112202212122001021010022122002222102102002021112101222020102012222221002112201012002011101200111020101201102204-
421100101022101020211220102201112112100021112022011100101021001012020010022021121020222222101200121002210211011011200020121101101022011210222211220024-
401011120120022200211001002220201021102102021111200222002101010111101112101020210001221020200102002000111020220001101011020012000011021112011121110024-
420001011120001112220222111201210221022000101202020000110201021221120001122012110200120021111212200220200200101121002021110021212000001200012200010114-
401122011201211022100021001122220001120012111002112101010012001010201210012020222121121222011220121111110220221221112001101100222021101001012221212204-
422200111120210110121112122110202222022220220220220000210211010022101202101220022012211011111220101202221210210122120011122101211121101021121012110104-
422110011021010222122011222011102220122021110022022122121001120201020202010022220000202100212021212110202121002111102210100022111010011010101211202204-
401100211122210210101021021111120220210202111010101020002210221100000020210220000112020212211200220000121002100020120111211100201202122101210220121104-
402022020020211112220100220220011110222000122001020220002002021112122122201001121110211011201022202101021200102200010212011000121020111201111002212014-
401102011210002201121102001221101022022211221222010020011221010010100222020010101200212210002211010012200220111221120222000021101110020021222011012204-
401100110200210201000111212202220002110010022202011100201101201101212101000020002000000112121001010212002110201022112222010020210010001111012021000224-
410110220220020011222120020101020121021221221100212222100210110022002220101100202011220222221122102011020212001020200112022021122102020210000222101114-
411121102221021100201102120101202021001002110200121210122212111112020012120222211210222111002220210110100210222020201021001211220011022110202211010004-
401122222202022101002102221210112111110202202002211120212002200210102020100122020220202102122210110221022122122202012022122112022100222221120212200214-
400212021200202011201120201100011012122122222202100000111212021102021000112022212110121021102220200210001112222210022211111011120121211021022111001014-
400112222000202020222010110110022011000211202110112222022001202222202022101212220221220121111010201201012012210102202020101020112001001222010121101004-
422020022102122210221212201212022011020011111022122220110021100211012220101100200020210001021002102200102001111111112202102212011210121100010000002004-
410122122212202121201120220110110102101022021100210222222020211212200102202101210201110012220220212021022022102022111012102121222100220100212000011214-
412021111200101111021202011011102011000200211112000220202120200010010100022201001011112002210101111021000010022211000011001020010101111021022101220004-
422121120021001000200201211020002122000201021121002022220211101001101102001002000122012120201101220201000221211001012000100210020002201201201021120124-
444444444444444444444444444444444444444444444444444444444444444444444444444444444444444444444444444444444444444444444444444444444444444444444444444444-
