444444444444444444444444444444444444444444444444444444444444444444444444444444444444444444444444444444444444444444444444444444444444444444444444444444-
401202220102212011022220022011020102001000021000221020001211121001112122201001222012212000020222120022222020022221211101102101200002200210220122011014-
401001220120112010002111102012011201101111202210221002020001001222221221012102120220021100120120011021022100210110111020121222120220001020221021002024-
401112012220022120210021112010001010012212211101000122212220100121012200012202020021001001110121020221110201000021012011001212020111201011120111021024-
422220100011222212020202210222212211112122102120220110201010012111121001201010122200202022000211221110222201022212010000212102002012110112122021212214-
400220011000021001012202222010112111101021012222122000221101020020000022201020022210210010121211011101020011000001222210111222110021102221220211102124-
421100200000020001002111110122120011101101120010210222000120110102000201122011012202022021000120200101000022121220112211222020210000110022102100221214-
412021012012211210200002121210222112202021001100120012200121122121000202112110010202122011211200120011102112012121112011122001221222202111112001120024-
420111011211121220222002220220021122102111110110100002000121120211102210011002100211102110120100022120012011202021121012222100200211001022211021020004-
411001202001012202220022001212010002212112100010122101210210121012110012110011210000012110220002121012211211000210211022201022210001210002001111001004-
400210020002101221220021020101220122222110102020010001220022121200112121102002210200201010202222001201112222200212111101012220012120211221201002200204-
401221121001211112020212211122011020122111222210102220210001222222202002122201112211220101102221202110212020210012202110220202100201110021120121210024-
411102000022022201101102210211102100222212011122120202011201022221221120212101212110112212221212020011121101012001121000001012201000022210211020211114-
410120101112110002222212112111102111210222221122222021122200221102202100102000021022201121222000000100001121222211212002220011220020022120122222210204-
402222121100212121112002200221122210122102100202122220121112111010000102110010211202222220102110220101221200122100221100211120221200002112112222210014-
400002122100011101201002100011201001111000221022210002221210011001022002000011111111210020121010222022222210200122212000012102220201020020102022200114-
422111201010200001101021010222221112102012212200110200110221220012221101100210111222211202101200220210121221002210012221120202102121122111221020212114-
412021201021121212102211211100001220002112212101212222021000102201020211220101101211100120102220200020220022200122110102122221201221101100002120001214-
400122202002201002021012222221020022012020002202202102012210011212112200002001001020211102012000111001020021121012211201111112121201001110100121221024-
412122012002212200000120110121020211202020120021222201200100110120001022120101221111001202101021001101012100100101000022100211222210122120200100021124-
410012221020122101212021002221022101112000221011110211112110120110220222210122010201020220101100212200220112021011211000110111221120101012102210002214-
421212120202100210200011102200210211221212010101120120021002212221002220110121120222111001010020201000000001001212112110002202102102002021121221110104-
401201120220000020000220100000222200201001202102012202012000020111102201111121101020220201002022212110220002000011221101200121101120111000121122101224-
401000111012011002012220212101121001000012012010120201020010222022122022121112202210002010210112121120200222002221222100020001012200222110222101201224-
422211121221010201120011100002120201111010201122201001011102110011210011201220200222221211121122102002100200122211100002021111110201112021212210000104-
411020011101200211020220212021010110012102200000222221122102010001221010012000022102001201211200110010220210100200122200111100010020110112002212012024-
421021002002021212201101120221210211121012221210001100100200210202021011021220210000012001200201210002221001020212210111111211001010010012100221200124-
410100011122220011221100212020111110011111212101100110122202000200122202012122000201112220101202122120210212110202120210211212222100020212010202110124-
401110211201110101022121202012200201111100222020121000211210022000000110122221000022111021002202000212201002002110020100021022122222201222012110010224-
411210021112121120121220200210112210100120200222012101100210111112212121021000210012000222200122101111021121221100021122201002021221221020222221020214-
401112122202221101111122201011010020102222011221102020121121102021221220020200211200121220011111211112110111020020202201001022220120120222022202221114-
411020020221101201111110212121101201001021111202022202202210221001010012100222201112110122010221120212220122122100022020012121022222022102001220112104-
420011122010021212121020201212022010120201210112010111111120212112122010202012202200111012021001220120101001202102021122020002011222010010121101221104-
421100021012002002012010201020222221211212001220101101212101011220100102222001220121020221101020101102022211212002000220102200012210110120111212101114-
421201112110200220101110001222110222212122102020110222010010221112212122221220200001101021111120201112022222101210020102220220202201021202220212022124-
421201121020022011211010121021022112120000212200020200010221211122221112020000222121001001122101120111101220002020210102000201112010022120120211211214-
411022200201100002020200221222022111220102010112021022100122102021222202100221102001112022201212011010021022110101121001102102001202210212112021201024-
421112202211102220122101002100102210222002210201200221100111201021201011211021021021021100022000021212121120010111121120020012210012121020102222111114-
422022222212102120102222000010220001012120001221202101200100110011220011001212102112020100220010120000200000111120112101111111112212112100102120011214-
412101020012202212001112010201200220110000002120021120200200201211022120220112021020012111022122110110210022111222202201111000201212222121002112221014-
410000100001112210202121202121120201000021100200222200202022120111000021212222200201101012112001012112000202010022202200011202122022120201110120122224-
422122102210121202221220222011210022112012221110110101000122221020102002002110020211121201012001200100011212100000020010202121010211221112012110122014-
421022112111200011110221122010110110111111202010122122121120020122022011221002102222100122201000201220121101101202112120012111111110201102020020022004-
412120101122201000101001121110110020122120011222000202111220120211201011201222020100012221212001101210000102200012211220002220001212021012121010222024-
400220122112222120221211001012201011020100122212100201221211220100110221202010021021112121022000222102211020102020022000110101020220221220220221210004-
410211122000010011221101001111100011202000012222021012001001020002001101221112002210021222020211110001001000210101201211002200021201100210020220110204-
410112200222010120121101121202020210121001112002010122212101200022002210222010121000120120001022221102222221202220210210021001101120222212201011101214-
422122101202022021200210022020102010000222022022210211002101020102111211010112200121101200221202222020011020121212010222022112102011112111111010001114-
411210220212120100111202021100200011020220010021202002211112122000112022222222121022201122021002220211211211001220101020111010102212101201202122011114-
444444444444444444444444444444444444444444444444444444444444444444444444444444444444444444444444444444444444444444444444444444444444444444444444444444-
