444444444444444444444444444444444444444444444444444444444444444444444444444-
412222212022202102210120211001021110201101210110202220212110000000220200014-
412021022102122100200212100102111221011112010012210122201220112210122011014-
420222202010110211012112100212100101112010102201201002011101211120212022024-
412001200022022011222201212001112212121012212011201110200100211101110211224-
400012111000211210022121222211222210101112222012012021100212020110110212204-
411121101022002200100200022201222112220000102012010212022222021200011210114-
401121020222121102202111212000221201012011201220110022002011112110102111004-
420112011120111001111110220110000020122022221121010002221001122002120020114-
412020001012020002020000002220021011200012122020220202110010200201010011114-
412200100020020212202202220021222210120100000200120112110112121001211222114-
400212122122120122120210202222002200000000201122001101110220222221200121204-
422201111011021022010000121002112012001011122221112200221202222220010212214-
401002122002211122111001200102220120011010002022001120002010021222102200224-
402112202200001111002121222110212121012201111210020000001002110212120210214-
412002200220010102211201200022020020222102210110011122012201001002002012224-
402102221202202100121220212221212001002221211120212221111121021122112100224-
411201201201122012001021011200220012002122010212200000212001002210202112214-
401122212210110102100012010102210222000022211221221211001121000101021201104-
401100021012112011111112222110210201220201100101221010110020001010220002224-
421102111101021120121110110221221001002010120110112100120122021011110102214-
410002002012101000000110202202121010111022211221112102012010120000212221104-
410121211221001121011122101210122001220021111121212021011122022120011010204-
400002022020022022202010222022000000001011202211211012102201020100102020114-
412012102221212122210201121222021210221122122022210002120211112112112201104-
410020200222001020101111001100011120022222000002122120200112201221201112124-
422022111221200112111020021020011101022202122002100200210000011210021102014-
402102000221101122210120022102011020112221110100010010112000221021121101214-
401012100012110110101200202020001001222220210000222002200200201121002201224-
410020210012110100012221110110210222210022022111200212020220000001202221104-
412010012001222200200011201021201121121021021112220002121101022211112201224-
411201021222012001020212102012222001122220120020002110101021222222110012004-
402010021200020100102000020020122211210021021011120020111011021010221122204-
421000211010120020012002021202222001220201102020220112212102122122112002104-
402122112112101112000001001112220121011000120201112100122121120002210210204-
412221001010112112221202111202012000202221110202221021221112012102200021124-
420002112220010120111212222211110102220101221002201200112200200002002210124-
410022101201110211200212211102012012121202110011012012210121121000002211104-
410001010212010100011202101111110021102011002212201120122122022001221100114-
421201110212112211012021012100002000211202110122201221011101201200222122224-
421022012222211020101112101020120110020012110100101002112102011212022120224-
400022121002210102220100010022000122111112020100120022212020101002112110114-
400102212122222102121122100122212111021111021120000022200000212101100221114-
411102211222101220220001020212122210002000121120020201122000100202112002014-
400201120101110211120111000000012220211001101201011100001211020001210102124-
401022201100102121212121122222001122120110000220200120202022102212001111214-
402122020201002201122220011000001002201221200020012010001021021000102000104-
421112221020201112112211121021000001210200000200002100210001101202020112214-
421221212221201000202122211122020112110121121220100122200102211020022102214-
444444444444444444444444444444444444444444444444444444444444444444444444444-
