444444444444444444444444444444444444444444444444444444444444444444444444444444444444444444444444444444444444444444444444444444444444444444444444444444-
421212220020211120010211220201111100211222200221011002212200010201000222110000110222201202011220020000110221010001110202020010201002202011201011002224-
411201122201000102002110201112122001120010120011102102010022200112102112201002222100212101202020112102212112221112102101111112122121021202110122112124-
420211211212100200201000212012001220200220012022222101120222011222222120111120000201211121111101012122101201101211120022021202110121221210201121102124-
412221200011210201010210202100220211012222211201201220022120002122111211222022012000220202011211200210011020011102222021221222112020111202122002000104-
410201210102020222011201100220200201201211212001222102122011111122021112011121220121111022000101021201111021120111120211221001101202210121021010102214-
400201002212220202101020002211101120022201121100011102012202101102001002111201122210000011111202200022120002222100021222012110221211222101120210010114-
421021111010221110101221110120200101211211120201100012020201210220120222220021102221202211210212002010111001201012000022120020202100120221121020212124-
400112012211211020012020221101120202110021002201211021201001020111112020112110212202020211012110012212110112201222100021121200121010100021202020010124-
400022102012212221001021201000020012101020000201002122010222220211222010121122212221221110211022210021212221100020101001020221011110220010200200001014-
402111000122021111120001012021220001021120022122120120002001000112001002012022100212111012010201111202101112122212000200211012110220112222210012212004-
401022120020121122110002002212221212212120111022111002222202101010122222021110000121111112221020020112202101012220022100102101021001021122020200112004-
401222202021201212210202012102210101221002112101202100202101222111011201210112100202222112221201121121102002212100010122021012022102110120102220211104-
400010001022201000111210212220222012210222102202020012021201210012100102000211211212101220110201010111122001121011222202110011000002021100221222101114-
412012200112012201111200101012211101002112121202200011212122012221200002101000000001010211121122210112021221000112220021212122012112012121000221222224-
410110102210222012110000122120021200001221102021112000000022002211021202020122011022220002102110220002100222121012011200202021221220020211001222020124-
410011100101011221221222111102220011010102022110022100111111100020101011001012022001110000101202010122001211100221020202220000002111102122201201002224-
412212022120202020000001002202000012120002101112010021021021000022222110221202021102002001222100000122222102202012101120111211020002122120001020102224-
410102202200201021221011011110012221220210212101001112101001010012112202122112212002201021112102011010112010112100001001220121101000120001020022021224-
400001201000020001222122210002202202000221022001222121001110010222200200102122111102202122221000221100002211200012021020222202211212001010111112210004-
412222122212120021120102120201021000002211001012021021201100022121012000221111202122101200201000000121010120122201010020000121200221010201101220021224-
422020200022102010010000012210002010022200100101012122222012112200212101022200121022112221110220101200110102122120112202102120020201121211121010212004-
421021201012122122112200010101100021120101101120202100220102110112000021110200112111102210202001011012220022001122200201201021111000200021221202200124-
410002122020101120121021021211202020100021211111121012211010112120121001222020111001022010121222022012022220122020010112021012210012022120101010210024-
420220121212210222122201220001011101120000122010212221211022111212111221000022202100010012012001011010021011201212110022110011111110222102212212111204-
400211122122011000200210210211112001121011101020110210100201011111000210001022101001112011200000102001012000211122112201111200021110002101001112021024-
421212112011021222010002011102120111102111200212110222011222210221122200022112010120212022100222222120200001110102100210200211200021121001121222001004-
400201112000202212212011001021111022212102102111110102220021021110220101212212122100012120211011100220220111120021211011100200212200220202200112021124-
421100200212000112220121022112121210001012020121210122012020222011020111100112001210112002200220201011221220122001211021211212002222200220100021221014-
411202022120012220021012211211101002221002122212012021220220212010101120222202022100012121012012102210211120100011021100021011211200000200210000222004-
420010120020211022010202002110120201201001111020022120022101221010021101222111011102210002100022011012112002102211100122120000201121200120211110111114-
422011022202111221212120221210122220102211111220112201011200110001122112000220022021121220112120211200122110122010212020000102212120200012202010011004-
420100022002221000202212222011000020101021010121120020100201121201201022021000112012112210210112100002111110002110011020002000120221222212120222222214-
412022220121001212010111210220222100012200111021200221200001022102020201121000022211110010211220222100201220211010012112221112120002022120022100101124-
402010120111201200100221121021112202020010200120022120111221222211012100201110001121001120112212212112220010210102020202110120001211011221220000101224-
412012201010000022122011220200110000001112211220000022200011022221222011122202121011020202010012211222000220012220222001222211200112200220012021121204-
410201222100001121120011212022000022002002101100220000122220221222122102021101010202221122100210201212211100211111021111111122011221202002111122011214-
421210122012110101002210222102102022002201100101111212120221202110001012202212100102200112210121100020201221010220202102102012100112021010100021201004-
421122120202010121121012022000122010220022002211110200100021000021011100202011110222210212120121001012211001101120110100000200000021212002211212212024-
422110101211220102211102200122002221122021010110220121221010011122122011102000110212010220102121222000120221222121011011020022212021201200110010202014-
420201022110222201002121102210010002012220020101122110102220011222000002112022120201122222201001121010110110120001020210111001221011100022021202202114-
402010112111212211021111122111110120012222020010012100211210112102121010102122121112212010102222010011121121220100222022020020010222012210101110110104-
422221111201120120012120210010001120210210002011222221110200202222212112000022100120212012022001110201221002021220100122200201022101100101021100201124-
411102120010211111200211100210212202101000220222202121101011120200201220211102121220121200211120101022200201000121010011020100001102002211101022120224-
400020211012100120121122222220100022021102121001122102001100010200022000102112022001101121200010210102102122022101002101012012221111010021102002000114-
421120000020110101202122100101202200011000112112000221101212110102110100220221020110220111211021201010002122222100001101212021202211102210001010122104-
420112212212100200221021100200112022202022211011222100022110022122000100011100010122211102220022001212110102201210012000210022210020202202210200010224-
421001202011001101000002111120210112201112222221122111000101200020220202110022000022200100110112221022012200210211122221011220122002101200000102120214-
400101100221211202200210121012001012002011121011020011100002022111212202202222000220202212201220210122212011011222211021120221221012200222112122211204-
444444444444444444444444444444444444444444444444444444444444444444444444444444444444444444444444444444444444444444444444444444444444444444444444444444-
