444444444444444444444444444444444444444444444444444444444444444444444444444444444444444444444444444444444444444444444444444444444444444444444444444444-
402120000000220111211210122122201010102112210122000201012212012021102112101021100220200020010010201010020222021122101111121222222010110202000120121004-
421001212112000110011010022201201020211212101122001222020011202021222002002220012122000221022022012122102002100111220121101200200222200221110220101014-
422100220100012122111210222121122202022110220001201022012110002210211101211220101002002000000012011211100001000222001100210202021102010212120201021204-
410112222122100111202022211011000112120210022102200020001211121111202211210220221111001111221221021111010211000012202111020101222021222212221120021224-
420002110122000201222111111202120110111220121122121002110222002110001101221002212001212211121211022211000110110110211220122121000001100000012201100014-
402020101021021020121011220100112021201200210221122010210201222010210212211010222002112121221021121221111110202100211100120010102010101012020212110004-
421220010001022102122010222100002000112220102012000102211020021101102211210210121000101121011021202202001112211020010121220101210111002212000210202024-
420111212212112111201022011100000022202200021000001111111201121102212010102020102220002120101000112100012200200011110122000210122012111110002012122114-
422210012110120000121121021102210011220101000011100022221021011000020111100110101211201222111010012210221210202101122222100000111212100211022010220204-
400222222122122112211102000012101012211022120222011222011121110100211012101011122211202101011120211111120212212101021111110221000221221122101220010114-
402000211011120002221000102202012100112110122010012010010201110021010100001222100122021110221221022221121202222011201200122201111121201212111222012224-
421222012001102112211122001012201211001202212210102111112020011021022102112000011120222021200022001202020121012222000212011020222010100122001122221004-
412022220012211220211102010102120001111001121110212011220102020021210000120001121212200010112020112101000112002212222220211222101102220211222111020024-
401110110011102120102202101012010222022002221120002101000021010210222000202212012010102000020220221022220100101000020101000011010101210121120122221224-
402010011201112212120001122101022021021201102011011022201100222022101110111220102120011120202012210110112220020201001011100021021012010201112221202014-
422022200202120121020001210200001222111110020210002212021011200002220220000001201200021222211000121020122021122101011101110021202020120212112212211214-
400110101112012111220222202011021010201002022022222220201011111022000210000221120010211001202100112000011111010100200112011122000102112020111020002104-
412122210211220112201122101010201022101101100221120000100120111021202202100101111202211100001102101222102111022220221202001012022200011022121210020024-
420201201211002220022200021122211112121122022122102011012120112200202201201011010121120221101021211220010200010220112222221102022001202102022200012214-
421101112221002112101011020101121100111200010222112122212012102010000112120112002012022202022212012120020201010100101112101121111101000200202210012204-
421210121020101101210120212220020110201220022102112221110121012120101221022120011001100212010101002200022001000110211001212022010000200002102001122214-
420022210201000210102210011111221002002222102122202200221202221000110020110211011122001222110201102021012120112021200200011010212101020011001120202114-
420012111122101120121021022120012010002120002202021120020220210101222111020012222220122121020220112002001102011001201022010011212112221210102222121024-
422201010011012101210001000121010011221201211200020200212100001122202010001021101102202111020100001210211022100101122112220210001001211211020010202124-
402101000002221021111011010002110021210100210222201000012020211222110002102221212100101201211100012201122212101222210022211221210210220212202102202004-
402020000021112100111001102002221201120112002011012111010211010112000200021200201210111010110022112010000111020212112100101212002001011100102102111204-
420101021211221201112111212120121010211112202102201212200000102101222020110110222202001100120102021000122110222212122121210200102000211222002011200024-
412021221222111210221211221011102122222011210102212200212222022211011212201201100211000202201112222220111002001200020012010021022122012001122011222024-
400020001122221222011021012210221121021010001110121120202211020200202022112110100021012121000222121111111212220020002010001002201002100011011221220204-
422022022200001121202120122012020212211102110202202010122212011220101110220121020100220001022122010022212201112010011101121002212212020012022212122114-
411101010210122010111212122002012021211102211210101020102102011011211122101011022000122011212102000011111012100202221202202212100002022000020220022224-
420101202012021000122212001110122120020211112000122001212020120011212220022212100202012022021112001022001100012020201020000100222210010100110112011114-
401112201212111120101200120210001001202100110110221112100220212001102202222200001112010102002200122012011001102001111012221210022102200012020202201224-
400022120122011100110222002020120111221111221121122222022222011200111012221011110012022100201021120100201122210022012212122120220220122201212020021124-
422102011212000012011120010011021201102110020010022022002122100021121101100122201102100001200212111020201112010121201021211122111222102220211012000024-
401101111101002111211022120220100222021220122201110002120001111100121122220111100200112121111021011011022110002222002200000001011111112121211220111224-
400100222122100101102111012212121021121022222012110001020222212000021121121201110021201121021210212212200010222202112121210012120010102121220222102204-
412000111112100202000112120020110220110102002012022202100022101212011220101000110000202001100020202102111022110021220220200021222111110000200020200114-
410002121022010002202112202101221101211221200101012120211020102221010122020121102101210112011122122221011112111200120102102202211112120222212112221204-
401010020110202211012121102002221200110212010022100101122012101012122021101120211222211112021011102100011002002122100011120201211201021110100121010014-
400210220000121221110222010202120212100201222112012201201020020000100120001202100201102022220120110110222102020120111010012211122020221022011210100224-
400111012100211022002100101102211012000111121011212202211120000112020000102101100021001022212000220200121222022011112110110200112202021202001212120204-
410202220222000222110101122011221001100011020122211010021211100202221100221112202101210100000200002012220120100221021022210121222011112101220022012014-
410202221002221102102210121221120020202200110021011011000011120020002022110211100000200022201220002221102220022200000102201101002121220111221211201024-
410202110012101111110112210101211220121101000110121001021211120111112010200221000211210210020001222102020021000010122021222201121102012212210012011224-
402021211001022212212222201120210001012010001021100010202011220221110212011122020001012200111100011020112102202121221002212100212120202121102201002004-
401101102202022111212201010201222101021010101222111211101011021121012101011210201111121112101222221211212220010222011012211201012201022002000100212104-
421101020110002022020010201120020001222202021011110100112201101121010201122222112211101022101201012020021222111001222221022201101100111010001012111214-
444444444444444444444444444444444444444444444444444444444444444444444444444444444444444444444444444444444444444444444444444444444444444444444444444444-
