444444444444444444444444444444444444444444444444444444444444444444444444444444444444444444444444444444444444444444444444444444444444444444444444444444-
402211100001122112010222120012211121001202220201100011112112001100212211002122212100112212202200021112122211001210000102102220220212110120210100022204-
422210210000002210120222212001012120000002100222210201112021102021101021220010201200201112201210101111011010201000001100210002120220010021100212201014-
400102111200121010220020002222010011200000101012011011120121221121020021000020002011220200121011121002000110021211200201000222110220010120121122211214-
401010200222012002100120021221222111212012010002210122210112011211200112002210112011012021021001022222011220100200210010222211201121210002101011011104-
400112022012211020201101110110112010121221002000200002200021200000001120122112012112010220201020001210220120120222212001001001222010202012220201001114-
410121022012011000110011011202200102021000111201022022020211221001211101121022111202011112112011010020210112110200002221122011011201002122200220002014-
422220201111021122020002220002221221122002102222112212011222100201020021022111220010100221122110211012011010220221001201200010110200220010202101112124-
420222101210222100200111122000221202011101202012212101100012120201022121022210212200020202121220212200001211111111122000220112201021112012120102111104-
422102212021020102010112002111220020011001020211110111010111200021001101212012212021201002202201002011102012122201012020021212211121020000100112211014-
410102111101011011120010111220110011021022111022102210002222002021100010010022011200202022112200101012111102110222021202021121000010110221120121022204-
411110120122211110212220120012222220202010200012121120000102200222221111012222222121221022021111222021002110021122202210100120021211110022022200201214-
420122012120000222200122121120011210202112010021000220002101220222201022111111020022121000002211210211220220122111110222211210022022021010201120201224-
400002011010110220222112101122112021200120001010000111121222102220211000021010112110221121210201101220221010110221011100221021200000101101120120000204-
401022110210200022010120011120002101102100112222120112002122020110020100212222000011000121201202112220201121122210200022110121020210101212022222202104-
422011012100220020110021012011101111201201221111021101120110120211110210021012201212112111102021212201002222101012100201121220202211000220110101022204-
421200011021122011222000100201010201010100002111010001211021120021202210000200021021102002010112221112010220200011122202012021001022010210120102101004-
401112022122210101112110021121212121222010101010211111111011110011020111100020111201012210101012200200020200220112210210221110102021111220122011211124-
421102020112222020221021121212000020122101222211222122200222202222122120112211020101000100012211022002102000001000220210112201221021222010201212202004-
410122221010210212011222220001001020220111011222202012221212011121120021010121202020121110210121121200210012202020122100020211102001110021102202201004-
400212202000110022000200121202101210010022111200100112002022020121022112020011201122222112020102222101122022121021020000111000020022110111122222202204-
412000002202020210200020101000110000222221121012010200220222201021122100112211111222101100111110220102000121101012011111100220122020101012102221122024-
420201101011010010220011122212020101021012112110100101011221220202220012210000020121201212021021120112012010121212120010202111212212022222201100101114-
401220101122222100112102112010110010212221010111200201210012022210111222200120121101221122222201120210102011001200120212001211122201120201021221022104-
422002002212101112221212022200120101212002012020200201011001221101121111110020110210100012202222012202211120101122000202221101020020112212110012012104-
412120221212101012000022201112201002001210221020121110012201101111011010002211000112112021021110120201220001011022122120011012110210011020020102022104-
422022210012112001021211121000001010201120200120110200111011112020101110102221122102000012211210200022201022202201200220211121110220122002210201120014-
402021010022212010212221000122101021012020110021022101202122202021100100000111210011211010202120010121202200201212102201020011022210022000200001012004-
422212010110021200221022202111221121211010120012220110102201100011202002222102122021112112220022020212221000112102212100101211202102000100212022100204-
421110002222112111000200110002221200012100001002120212220010212120011112212221001201122100111222211001002011222200211200012200112111121221212101221214-
401102101000122102102210011000001010101002101122211202002221112012022111000200100201012202220120212220100222011121122210121121121121000002120110101014-
412111110100121002001012122121110112021220122022221222011100201010111210200101210102202212020100120000210220020020212110200122010112100000110210122004-
400000102002020120201011020211221012201210021002000001220210000222012022112210221101222121102112221201022020100211012120101011101222211100122001112124-
412101020021021112212021000212100201020000111000022101011210120001200002012022011001122000020001010122110200022122222121102211010202021000202000101214-
401100022021221102210001021012020020202210100022020122222211020011020122020211222012100001202122020001100001101202212110122121212021010111202001121114-
400210022101021120000010122200002211011010101122100101112000221122202100112012120200100201121012120010122011102200210220210120111211020012210211102004-
422221110102112200220000102000221000221221100211212202001221112011121202020111120002100221212102010002100110121110011001011100002001210220222100122004-
420011011000200201110111212110020000100111211120211010121002122021221022102221022010002112011212111010010110220102221110202100112122001121201101211004-
402222001211202111220200221112000120201020102212211021002010220120010200122200112112021021110200211211112010110011001201101112011210010021112001002024-
422010220101201200021110020020101020022200102100022011121021111101010202212112210200212112210202100120122002121012212122010100211001111002112011012024-
421202100100002202010220001100022002010222122120102101012111121100202001222222011120122120101201122220121021022002011111001012120210111221112212100224-
400011202220101212110101111020020200100200202011000200120012202110111010012202022211002001101111021020211120020012001101101100002011020000120220001114-
422122220121101101111121120122101000021122002100202222010010222010112202222022110210002221221002101110201221212102020100221112102210210021101120112014-
422200110102102202022121010001201202011101222222121222122101002222200112010010111010021122002122012102022021201001010000022210010210112121111001002024-
422100020102200121002110022102210021110220220022100222010202112221010121001202220022020210211220001200020012220102021021202021121120211122111112100224-
402220022212021022212020200022021111201200102211201020010211102002202111020210222211201100211020021002102011001011212022112202011220110111121220221024-
422022112010210122212011012110020202202022120001221001212011212111121211210112120121210112001120001200221112010010001100201111021020121212111100112014-
412010012012202002201211102002002121022222020001112212201110100220222212201220222100211121001002120011211011120200212020121010100001121020100220001204-
402000020022011011220202201200022000001202200121200200010001201102110222111212122122010020220111110122201101220101021111202201011002110012022202122104-
444444444444444444444444444444444444444444444444444444444444444444444444444444444444444444444444444444444444444444444444444444444444444444444444444444-
