444444444444444444444444444444444444444444444444444444444444444444444444444444444444444444444444444444444444444444444444444444444444444444444444444444-
401102021112122222210200101011202001010121121222120011110220112022212212211202012000212112021010001001112121022122010022211102212111110021211122121204-
420222001222000220022110010221110000102200022121020001210020221121012201012000011022001000211110211120112002221002011102201221012011022122212011121014-
402200110021211022012221211200021210221020000210010010102111200202110000002112222001110211021020120222002020022222002212210201021001201100001111002014-
412202111201010021111121200222211021220112102110022000222200212021001000021102002120212211210212210220010100121112100110011222022000200110001112210024-
400102221102210120112202200001122122222102110010001122021111201200011002220212021122111112020010020011110202102221112100110000102202221101222020011104-
422120011021000202112120111022221220202121202010001212222000100221102101100121202022112201020122100101020211201221010211212022111212100001102221112114-
421110210222022222202110120121100202001100212021001012110022112010202202202222221000002100220001210102222220101222101011100221200022122100220122120114-
400022210111221221200110110211101002010112221102120201011101002221010211210001021012122221110000221110000112102000112012201200101012112000000220100104-
411222000101110122101022200220202000220120002101121022001011220210101221121000212220111212010120201212212100011101211202112021122002111122000001021004-
421201212210001201201112211101211201102222222020111110000111212111010222212202110001212110122212102202221102210222211201202200012100002211000220200004-
412221210200121022202200021220202010021111110201122221010011012212011001011011022202020212220220122212120011210002021001020001200201220012001201100014-
421202002212201000110110001211222112010000112121210011112202210121220200000011202010101200111001101212212101102111121221112011001200010111020012022024-
400112111011112212220211102221020211021120222000000011100021022212201121211010122211212022001020201000121112100022201220100200012202010010212120201024-
402201112122210112111102121001120101102021221112112202201012100012102201100001011001201002102210022111112101022121110202221221111121010022011010221204-
420102101201102112012021201121011221002122220010102200022222121200210010122201121102012220000112122200221001102020002201120012021020221001012020022014-
401102112221111122020211221121000100201021212101222202111112111212000011020020112201012210202112112222120200221211212220221221211011221221100110012024-
402100211121001110222202121021000210102002200020221100010101202011222012112110022220120002200022120222011022100101110210122210200011020022020202211204-
400020101121000012002102122010011022000011221202221021121202221002210100012002010112021210200211102100012100222222012120211010202010210021112220212124-
401101022112001121122102210220210202221211020120012110111112011021221102110102110001012220112211210022212101121002122110001112011222110010001022022024-
411000212120222120022211201022102000210122002122221211022110221112110120200211222121211120022101222001202101012010112010101111001100200111101222212224-
402021121011212010111110020210011122221200012010211100021201102222011220202011120122112202002202001010210101100202212101112211011222112122100210201014-
401111220220122200220202021110022102001211220020110220022101212101112121021021020202200020012122210212222120212111110212202000022002101001201110202224-
402001211111211211120000220221201222221120201102022220012112210121120012201111112212220101022110101020012100221110220211211121212122112001112201001114-
411111122021020001220212001000120221020021201102010202102111011012000211121010102220111212121100102002221010100210102211211101020211000201012110221004-
422112201112012121001000122002101011022022200020021200111201101202101012020000011021122121220021220101120001210222021011120200010020210100001222220014-
422102011011202202201020102021201011002200221220110212200101212111110111202212212110202120102122202020121222121110102100101011002122201202222112110224-
402022110210120122012000012010211000021220220021211001121012212021021101212112101102001012210100210020021102202101212222112201020202202112211112110224-
400220010111200211222201121021122011222022120111222010010212101000002211110201101100100021110021001221020000211110002201010210121201011220211000020104-
400202221000101011102221111220201000211112211200022211111222220212120110120121222011001210211101221212122012200001211022211202120101210002100222200114-
412221221212000200221210122120101122122212221121000102121021120110112221011100022101221011200110222201110022122001121021221112120101011010122001120114-
410112222221220011201022111220022122121100020010021202212011202010120021100100021011111220001010111111112022110121112202212111222201222211011221211204-
421212121221121012002001020120201022222020222220000122212001221021122120222202101212221221002102201221120010010001020120222121212101221122001211201114-
410212001022111020221102212001222022100112211011121010200001002002020112010101211000122101220101121002202011201122222001220201112200112012000202221214-
410200120222120100021200101212011120222210121202110102002110220122102000110221122221201021222221210110200012021001020002201221102010010221010000000024-
401222121210221222122001202211200120210011020002011200202201221002120122100101112200022010120212201122101112112002210011112121102100021212210121000024-
400201102001001102022020202221122200021102101211210001220222201012210212211202122011110202220022001110120202102102202101201112210102020100022212110204-
402122121120212022210222222122202101220212001110012211110010011221002100021002002221010020211222120200110002221110011111112220122200020220011210020024-
402101020021020222101111221021202020012212112101221011020210012100212122011122020002101122211101112201110011200120102222202212101221222011210102222204-
412122021122121021202110121212011222111101100221201002011021002100202102022020020111011011101122222221201002222000222211000111221221102210220020002214-
411222201012000110210000120220111010220021021111212202111211122212200012202211221200111201111000011102012222002001220101200102120212012120001210020014-
411111100222121010202021222001112122220120201100220012100211201012212121101022112101121021010102111012201211222122102120022011111102012001101021202004-
410221100220021111112110120122210010221010101202212102021220120211122202110002210201122211000120200100021212111011202112000100011211221222110120112224-
400022201011122101220211102000201221110222110122021112200122000020221101222021111221012101002210201220010102120110002211200222011211212201022212210204-
401122122111210122000210022120200101101110112020020120102112020110010102020210212211110101011112010102200110202012001111212100101111022200121001202204-
410122221122011211111200201022211221101111111210001010020122201021202102201120122002010111202201100122020012210222110000011010021020212020012010102114-
420001221012111101000221010011111221001100102010000102121002002201012201011002101121120021212020220000101211011012221111112210120210210022202201220224-
411200110102102112112002201200221112202002120201120120221201100211210210110102222102221021122101111221111210111020001101011110112220200222121200022014-
400022000101212022212121021120220101120012101000110021221220101011212121100100211222212021001001202110112221220211021101221000020220100120000011202124-
444444444444444444444444444444444444444444444444444444444444444444444444444444444444444444444444444444444444444444444444444444444444444444444444444444-
